iso	seq	len
tRNA-Ala-AGC-10-1	Ala-AGC-10	GGGGAAUUAGCUCAAGUGGUAGAGCGCUUGCUUAGCACGCAAGAGGUAGUGGGAUCGAUGCCCACAUUCUCCA	73
tRNA-Ala-AGC-10-2	Ala-AGC-10	GGGGAAUUAGCUCAAGUGGUAGAGCGCUUGCUUAGCACGCAAGAGGUAGUGGGAUCGAUGCCCACAUUCUCCA	73
tRNA-Ala-AGC-12-1	Ala-AGC-12	GGGGAAUUAGCUCAAGUGGUAGAGCGCUUGCUUAGCAUGCAAGAGGUAGUGGGAUCGAUGCCCACAUUCUCCA	73
tRNA-Ala-AGC-12-2	Ala-AGC-12	GGGGAAUUAGCUCAAGUGGUAGAGCGCUUGCUUAGCAUGCAAGAGGUAGUGGGAUCGAUGCCCACAUUCUCCA	73
tRNA-Ala-AGC-12-3	Ala-AGC-12	GGGGAAUUAGCUCAAGUGGUAGAGCGCUUGCUUAGCAUGCAAGAGGUAGUGGGAUCGAUGCCCACAUUCUCCA	73
tRNA-Ala-AGC-13-1	Ala-AGC-13	GGGGAAUUAGCUCAAGCGGUAGAGCGCUUGCUUAGCAUGCAAGAGGUAGUGGGAUCGAUGCCCACAUUCUCCA	73
tRNA-Ala-AGC-13-2	Ala-AGC-13	GGGGAAUUAGCUCAAGCGGUAGAGCGCUUGCUUAGCAUGCAAGAGGUAGUGGGAUCGAUGCCCACAUUCUCCA	73
tRNA-Ala-AGC-13-3	Ala-AGC-13	GGGGAAUUAGCUCAAGCGGUAGAGCGCUUGCUUAGCAUGCAAGAGGUAGUGGGAUCGAUGCCCACAUUCUCCA	73
tRNA-Ala-AGC-14-1	Ala-AGC-14	GGGGAAUUAGCUCAAGUGGUAGAGCGCUUGCUUAGCAUGCAAGAGGUAGUGGGAUCAAUGCCCACAUUCUCCA	73
tRNA-Ala-AGC-14-2	Ala-AGC-14	GGGGAAUUAGCUCAAGUGGUAGAGCGCUUGCUUAGCAUGCAAGAGGUAGUGGGAUCAAUGCCCACAUUCUCCA	73
tRNA-Ala-AGC-2-1	Ala-AGC-2	GGGGGUGUAGCUCAGUGGUAGAGCGCGUGCUUAGCAUGCACGAGGCCCCGGGUUCAAUCCCCGGCACCUCCA	72
tRNA-Ala-AGC-2-2	Ala-AGC-2	GGGGGUGUAGCUCAGUGGUAGAGCGCGUGCUUAGCAUGCACGAGGCCCCGGGUUCAAUCCCCGGCACCUCCA	72
tRNA-Ala-AGC-7-1	Ala-AGC-7	GGGGGUGUAGCUCAGUGGUAGAGCGCGUGCUUAGCAUGCACGAGGCCCCGGGUUCAAUCCCCGGCACCUCCA	72
tRNA-Ala-AGC-8-1	Ala-AGC-8	GGGGGAUUAGCUCAAAUGGUAGAGCGCUCGCUUAGCAUGCGAGAGGUAGCGGGAUCGAUGCCCGCAUCCUCCA	73
tRNA-Ala-AGC-8-2	Ala-AGC-8	GGGGGAUUAGCUCAAAUGGUAGAGCGCUCGCUUAGCAUGCGAGAGGUAGCGGGAUCGAUGCCCGCAUCCUCCA	73
tRNA-Ala-AGC-9-1	Ala-AGC-9	GGGGAAUUAGCUCAGGCGGUAGAGCGCUCGCUUAGCAUGCGAGAGGUAGCGGGAUCGACGCCCGCAUUCUCCA	73
tRNA-Ala-AGC-9-2	Ala-AGC-9	GGGGAAUUAGCUCAGGCGGUAGAGCGCUCGCUUAGCAUGCGAGAGGUAGCGGGAUCGACGCCCGCAUUCUCCA	73
tRNA-Ala-TGC-3-1	Ala-TGC-3	GGGGAUGUAGCUCAGUGGUAGAGCGCAUGCUUUGCAUGUAUGAGGCCCCGGGUUCGAUCCCCGGCAUCUCCA	72
tRNA-Ala-TGC-3-2	Ala-TGC-3	GGGGAUGUAGCUCAGUGGUAGAGCGCAUGCUUUGCAUGUAUGAGGCCCCGGGUUCGAUCCCCGGCAUCUCCA	72
tRNA-Arg-ACG-1-1	Arg-ACG-1	GGGCCAGUGGCGCAAUGGAUAACGCGUCUGACUACGGAUCAGAAGAUUCCAGGUUCGACUCCUGGCUGGCUCG	73
tRNA-Arg-ACG-1-2	Arg-ACG-1	GGGCCAGUGGCGCAAUGGAUAACGCGUCUGACUACGGAUCAGAAGAUUCCAGGUUCGACUCCUGGCUGGCUCG	73
tRNA-Arg-ACG-1-3	Arg-ACG-1	GGGCCAGUGGCGCAAUGGAUAACGCGUCUGACUACGGAUCAGAAGAUUCCAGGUUCGACUCCUGGCUGGCUCG	73
tRNA-Arg-ACG-2-1	Arg-ACG-2	GGGCCAGUGGCGCAAUGGAUAACGCGUCUGACUACGGAUCAGAAGAUUCUAGGUUCGACUCCUGGCUGGCUCG	73
tRNA-Arg-ACG-2-2	Arg-ACG-2	GGGCCAGUGGCGCAAUGGAUAACGCGUCUGACUACGGAUCAGAAGAUUCUAGGUUCGACUCCUGGCUGGCUCG	73
tRNA-Arg-ACG-2-3	Arg-ACG-2	GGGCCAGUGGCGCAAUGGAUAACGCGUCUGACUACGGAUCAGAAGAUUCUAGGUUCGACUCCUGGCUGGCUCG	73
tRNA-Arg-ACG-2-4	Arg-ACG-2	GGGCCAGUGGCGCAAUGGAUAACGCGUCUGACUACGGAUCAGAAGAUUCUAGGUUCGACUCCUGGCUGGCUCG	73
tRNA-Arg-CCG-1-1	Arg-CCG-1	GGCCGCGUGGCCUAAUGGAUAAGGCGUCUGAUUCCGGAUCAGAAGAUUGAGGGUUCGAGUCCCUUCGUGGUCG	73
tRNA-Arg-CCG-1-2	Arg-CCG-1	GGCCGCGUGGCCUAAUGGAUAAGGCGUCUGAUUCCGGAUCAGAAGAUUGAGGGUUCGAGUCCCUUCGUGGUCG	73
tRNA-Arg-CCG-1-3	Arg-CCG-1	GGCCGCGUGGCCUAAUGGAUAAGGCGUCUGAUUCCGGAUCAGAAGAUUGAGGGUUCGAGUCCCUUCGUGGUCG	73
tRNA-Arg-TCT-3-1	Arg-TCT-3	GGCUCUGUGGCGCAAUGGAUAGCGCAUUGGACUUCUAAUUCAAAGGUUGUGGGUUCGAGUCCCACCAGAGUCG	73
tRNA-Arg-TCT-3-2	Arg-TCT-3	GGCUCUGUGGCGCAAUGGAUAGCGCAUUGGACUUCUAAUUCAAAGGUUGUGGGUUCGAGUCCCACCAGAGUCG	73
tRNA-Asn-GTT-11-1	Asn-GTT-11	GUCUCUGUGGUGCAAUCGGUUAGCGCGUUCCGCUGUUAACCGAAAGCUUGGUGGUUCGAGCCCACCCAGGGAUG	74
tRNA-Asn-GTT-11-2	Asn-GTT-11	GUCUCUGUGGUGCAAUCGGUUAGCGCGUUCCGCUGUUAACCGAAAGCUUGGUGGUUCGAGCCCACCCAGGGAUG	74
tRNA-Asn-GTT-2-1	Asn-GTT-2	GUCUCUGUGGCGCAAUCGGUUAGCGCGUUCGGCUGUUAACCGAAAGGUUGGUGGUUCGAGCCCACCCAGGGACG	74
tRNA-Asn-GTT-2-2	Asn-GTT-2	GUCUCUGUGGCGCAAUCGGUUAGCGCGUUCGGCUGUUAACCGAAAGGUUGGUGGUUCGAGCCCACCCAGGGACG	74
tRNA-Asn-GTT-2-3	Asn-GTT-2	GUCUCUGUGGCGCAAUCGGUUAGCGCGUUCGGCUGUUAACCGAAAGGUUGGUGGUUCGAGCCCACCCAGGGACG	74
tRNA-Asn-GTT-2-4	Asn-GTT-2	GUCUCUGUGGCGCAAUCGGUUAGCGCGUUCGGCUGUUAACCGAAAGGUUGGUGGUUCGAGCCCACCCAGGGACG	74
tRNA-Asn-GTT-2-5	Asn-GTT-2	GUCUCUGUGGCGCAAUCGGUUAGCGCGUUCGGCUGUUAACCGAAAGGUUGGUGGUUCGAGCCCACCCAGGGACG	74
tRNA-Asn-GTT-2-6	Asn-GTT-2	GUCUCUGUGGCGCAAUCGGUUAGCGCGUUCGGCUGUUAACCGAAAGGUUGGUGGUUCGAGCCCACCCAGGGACG	74
tRNA-Asn-GTT-2-7	Asn-GTT-2	GUCUCUGUGGCGCAAUCGGUUAGCGCGUUCGGCUGUUAACCGAAAGGUUGGUGGUUCGAGCCCACCCAGGGACG	74
tRNA-Asn-GTT-2-8	Asn-GTT-2	GUCUCUGUGGCGCAAUCGGUUAGCGCGUUCGGCUGUUAACCGAAAGGUUGGUGGUUCGAGCCCACCCAGGGACG	74
tRNA-Asp-GTC-2-1	Asp-GTC-2	UCCUCGUUAGUAUAGUGGUGAGUAUCCCCGCCUGUCACGCGGGAGACCGGGGUUCGAUUCCCCGACGGGGAG	72
tRNA-Asp-GTC-2-10	Asp-GTC-2	UCCUCGUUAGUAUAGUGGUGAGUAUCCCCGCCUGUCACGCGGGAGACCGGGGUUCGAUUCCCCGACGGGGAG	72
tRNA-Asp-GTC-2-11	Asp-GTC-2	UCCUCGUUAGUAUAGUGGUGAGUAUCCCCGCCUGUCACGCGGGAGACCGGGGUUCGAUUCCCCGACGGGGAG	72
tRNA-Asp-GTC-2-2	Asp-GTC-2	UCCUCGUUAGUAUAGUGGUGAGUAUCCCCGCCUGUCACGCGGGAGACCGGGGUUCGAUUCCCCGACGGGGAG	72
tRNA-Asp-GTC-2-3	Asp-GTC-2	UCCUCGUUAGUAUAGUGGUGAGUAUCCCCGCCUGUCACGCGGGAGACCGGGGUUCGAUUCCCCGACGGGGAG	72
tRNA-Asp-GTC-2-4	Asp-GTC-2	UCCUCGUUAGUAUAGUGGUGAGUAUCCCCGCCUGUCACGCGGGAGACCGGGGUUCGAUUCCCCGACGGGGAG	72
tRNA-Asp-GTC-2-5	Asp-GTC-2	UCCUCGUUAGUAUAGUGGUGAGUAUCCCCGCCUGUCACGCGGGAGACCGGGGUUCGAUUCCCCGACGGGGAG	72
tRNA-Asp-GTC-2-6	Asp-GTC-2	UCCUCGUUAGUAUAGUGGUGAGUAUCCCCGCCUGUCACGCGGGAGACCGGGGUUCGAUUCCCCGACGGGGAG	72
tRNA-Asp-GTC-2-7	Asp-GTC-2	UCCUCGUUAGUAUAGUGGUGAGUAUCCCCGCCUGUCACGCGGGAGACCGGGGUUCGAUUCCCCGACGGGGAG	72
tRNA-Asp-GTC-2-8	Asp-GTC-2	UCCUCGUUAGUAUAGUGGUGAGUAUCCCCGCCUGUCACGCGGGAGACCGGGGUUCGAUUCCCCGACGGGGAG	72
tRNA-Asp-GTC-2-9	Asp-GTC-2	UCCUCGUUAGUAUAGUGGUGAGUAUCCCCGCCUGUCACGCGGGAGACCGGGGUUCGAUUCCCCGACGGGGAG	72
tRNA-Cys-GCA-2-1	Cys-GCA-2	GGGGGUAUAGCUCAGUGGUAGAGCAUUUGACUGCAGAUCAAGAGGUCCCCGGUUCAAAUCCGGGUGCCCCCU	72
tRNA-Cys-GCA-2-2	Cys-GCA-2	GGGGGUAUAGCUCAGUGGUAGAGCAUUUGACUGCAGAUCAAGAGGUCCCCGGUUCAAAUCCGGGUGCCCCCU	72
tRNA-Cys-GCA-2-3	Cys-GCA-2	GGGGGUAUAGCUCAGUGGUAGAGCAUUUGACUGCAGAUCAAGAGGUCCCCGGUUCAAAUCCGGGUGCCCCCU	72
tRNA-Cys-GCA-2-4	Cys-GCA-2	GGGGGUAUAGCUCAGUGGUAGAGCAUUUGACUGCAGAUCAAGAGGUCCCCGGUUCAAAUCCGGGUGCCCCCU	72
tRNA-Cys-GCA-9-1	Cys-GCA-9	GGGGGUAUAGCUCAGGGGUAGAGCAUUUGACUGCAGAUCAAGAGGUCCCUGGUUCAAAUCCAGGUGCCCCCU	72
tRNA-Cys-GCA-9-2	Cys-GCA-9	GGGGGUAUAGCUCAGGGGUAGAGCAUUUGACUGCAGAUCAAGAGGUCCCUGGUUCAAAUCCAGGUGCCCCCU	72
tRNA-Cys-GCA-9-3	Cys-GCA-9	GGGGGUAUAGCUCAGGGGUAGAGCAUUUGACUGCAGAUCAAGAGGUCCCUGGUUCAAAUCCAGGUGCCCCCU	72
tRNA-Cys-GCA-9-4	Cys-GCA-9	GGGGGUAUAGCUCAGGGGUAGAGCAUUUGACUGCAGAUCAAGAGGUCCCUGGUUCAAAUCCAGGUGCCCCCU	72
tRNA-Gln-CTG-1-1	Gln-CTG-1	GGUUCCAUGGUGUAAUGGUUAGCACUCUGGACUCUGAAUCCAGCGAUCCGAGUUCAAAUCUCGGUGGAACCU	72
tRNA-Gln-CTG-1-2	Gln-CTG-1	GGUUCCAUGGUGUAAUGGUUAGCACUCUGGACUCUGAAUCCAGCGAUCCGAGUUCAAAUCUCGGUGGAACCU	72
tRNA-Gln-CTG-1-3	Gln-CTG-1	GGUUCCAUGGUGUAAUGGUUAGCACUCUGGACUCUGAAUCCAGCGAUCCGAGUUCAAAUCUCGGUGGAACCU	72
tRNA-Gln-CTG-1-4	Gln-CTG-1	GGUUCCAUGGUGUAAUGGUUAGCACUCUGGACUCUGAAUCCAGCGAUCCGAGUUCAAAUCUCGGUGGAACCU	72
tRNA-Gln-CTG-1-5	Gln-CTG-1	GGUUCCAUGGUGUAAUGGUUAGCACUCUGGACUCUGAAUCCAGCGAUCCGAGUUCAAAUCUCGGUGGAACCU	72
tRNA-Gln-CTG-3-1	Gln-CTG-3	GGUUCCAUGGUGUAAUGGUGAGCACUCUGGACUCUGAAUCCAGCGAUCCGAGUUCGAGUCUCGGUGGAACCU	72
tRNA-Gln-CTG-3-2	Gln-CTG-3	GGUUCCAUGGUGUAAUGGUGAGCACUCUGGACUCUGAAUCCAGCGAUCCGAGUUCGAGUCUCGGUGGAACCU	72
tRNA-Gln-CTG-4-1	Gln-CTG-4	GGUUCCAUGGUGUAAUGGUAAGCACUCUGGACUCUGAAUCCAGCGAUCCGAGUUCGAGUCUCGGUGGAACCU	72
tRNA-Gln-CTG-4-2	Gln-CTG-4	GGUUCCAUGGUGUAAUGGUAAGCACUCUGGACUCUGAAUCCAGCGAUCCGAGUUCGAGUCUCGGUGGAACCU	72
tRNA-Gln-TTG-3-1	Gln-TTG-3	GGCCCCAUGGUGUAAUGGUUAGCACUCUGGACUUUGAAUCCAGCGAUCCGAGUUCAAAUCUCGGUGGGACCU	72
tRNA-Gln-TTG-3-2	Gln-TTG-3	GGCCCCAUGGUGUAAUGGUUAGCACUCUGGACUUUGAAUCCAGCGAUCCGAGUUCAAAUCUCGGUGGGACCU	72
tRNA-Gln-TTG-3-3	Gln-TTG-3	GGCCCCAUGGUGUAAUGGUUAGCACUCUGGACUUUGAAUCCAGCGAUCCGAGUUCAAAUCUCGGUGGGACCU	72
tRNA-Glu-CTC-1-1	Glu-CTC-1	UCCCUGGUGGUCUAGUGGUUAGGAUUCGGCGCUCUCACCGCCGCGGCCCGGGUUCGAUUCCCGGUCAGGGAA	72
tRNA-Glu-CTC-1-2	Glu-CTC-1	UCCCUGGUGGUCUAGUGGUUAGGAUUCGGCGCUCUCACCGCCGCGGCCCGGGUUCGAUUCCCGGUCAGGGAA	72
tRNA-Glu-CTC-1-3	Glu-CTC-1	UCCCUGGUGGUCUAGUGGUUAGGAUUCGGCGCUCUCACCGCCGCGGCCCGGGUUCGAUUCCCGGUCAGGGAA	72
tRNA-Glu-CTC-1-4	Glu-CTC-1	UCCCUGGUGGUCUAGUGGUUAGGAUUCGGCGCUCUCACCGCCGCGGCCCGGGUUCGAUUCCCGGUCAGGGAA	72
tRNA-Glu-CTC-1-5	Glu-CTC-1	UCCCUGGUGGUCUAGUGGUUAGGAUUCGGCGCUCUCACCGCCGCGGCCCGGGUUCGAUUCCCGGUCAGGGAA	72
tRNA-Glu-CTC-1-6	Glu-CTC-1	UCCCUGGUGGUCUAGUGGUUAGGAUUCGGCGCUCUCACCGCCGCGGCCCGGGUUCGAUUCCCGGUCAGGGAA	72
tRNA-Glu-CTC-1-7	Glu-CTC-1	UCCCUGGUGGUCUAGUGGUUAGGAUUCGGCGCUCUCACCGCCGCGGCCCGGGUUCGAUUCCCGGUCAGGGAA	72
tRNA-Glu-TTC-1-1	Glu-TTC-1	UCCCAUAUGGUCUAGCGGUUAGGAUUCCUGGUUUUCACCCAGGUGGCCCGGGUUCGACUCCCGGUAUGGGAA	72
tRNA-Glu-TTC-1-2	Glu-TTC-1	UCCCAUAUGGUCUAGCGGUUAGGAUUCCUGGUUUUCACCCAGGUGGCCCGGGUUCGACUCCCGGUAUGGGAA	72
tRNA-Glu-TTC-2-1	Glu-TTC-2	UCCCACAUGGUCUAGCGGUUAGGAUUCCUGGUUUUCACCCAGGCGGCCCGGGUUCGACUCCCGGUGUGGGAA	72
tRNA-Glu-TTC-2-2	Glu-TTC-2	UCCCACAUGGUCUAGCGGUUAGGAUUCCUGGUUUUCACCCAGGCGGCCCGGGUUCGACUCCCGGUGUGGGAA	72
tRNA-Glu-TTC-4-1	Glu-TTC-4	UCCCUGGUGGUCUAGUGGCUAGGAUUCGGCGCUUUCACCGCCGCGGCCCGGGUUCGAUUCCCGGUCAGGGAA	72
tRNA-Glu-TTC-4-2	Glu-TTC-4	UCCCUGGUGGUCUAGUGGCUAGGAUUCGGCGCUUUCACCGCCGCGGCCCGGGUUCGAUUCCCGGUCAGGGAA	72
tRNA-Gly-CCC-1-1	Gly-CCC-1	GCAUUGGUGGUUCAGUGGUAGAAUUCUCGCCUCCCACGCGGGAGACCCGGGUUCAAUUCCCGGCCAAUGCA	71
tRNA-Gly-CCC-1-2	Gly-CCC-1	GCAUUGGUGGUUCAGUGGUAGAAUUCUCGCCUCCCACGCGGGAGACCCGGGUUCAAUUCCCGGCCAAUGCA	71
tRNA-Gly-CCC-2-1	Gly-CCC-2	GCGCCGCUGGUGUAGUGGUAUCAUGCAAGAUUCCCAUUCUUGCGACCCGGGUUCGAUUCCCGGGCGGCGCA	71
tRNA-Gly-CCC-2-2	Gly-CCC-2	GCGCCGCUGGUGUAGUGGUAUCAUGCAAGAUUCCCAUUCUUGCGACCCGGGUUCGAUUCCCGGGCGGCGCA	71
tRNA-Gly-GCC-1-1	Gly-GCC-1	GCAUGGGUGGUUCAGUGGUAGAAUUCUCGCCUGCCACGCGGGAGGCCCGGGUUCGAUUCCCGGCCCAUGCA	71
tRNA-Gly-GCC-1-2	Gly-GCC-1	GCAUGGGUGGUUCAGUGGUAGAAUUCUCGCCUGCCACGCGGGAGGCCCGGGUUCGAUUCCCGGCCCAUGCA	71
tRNA-Gly-GCC-1-3	Gly-GCC-1	GCAUGGGUGGUUCAGUGGUAGAAUUCUCGCCUGCCACGCGGGAGGCCCGGGUUCGAUUCCCGGCCCAUGCA	71
tRNA-Gly-GCC-1-4	Gly-GCC-1	GCAUGGGUGGUUCAGUGGUAGAAUUCUCGCCUGCCACGCGGGAGGCCCGGGUUCGAUUCCCGGCCCAUGCA	71
tRNA-Gly-GCC-1-5	Gly-GCC-1	GCAUGGGUGGUUCAGUGGUAGAAUUCUCGCCUGCCACGCGGGAGGCCCGGGUUCGAUUCCCGGCCCAUGCA	71
tRNA-Gly-GCC-2-1	Gly-GCC-2	GCAUUGGUGGUUCAGUGGUAGAAUUCUCGCCUGCCACGCGGGAGGCCCGGGUUCGAUUCCCGGCCAAUGCA	71
tRNA-Gly-GCC-2-2	Gly-GCC-2	GCAUUGGUGGUUCAGUGGUAGAAUUCUCGCCUGCCACGCGGGAGGCCCGGGUUCGAUUCCCGGCCAAUGCA	71
tRNA-Gly-GCC-2-3	Gly-GCC-2	GCAUUGGUGGUUCAGUGGUAGAAUUCUCGCCUGCCACGCGGGAGGCCCGGGUUCGAUUCCCGGCCAAUGCA	71
tRNA-Gly-GCC-2-4	Gly-GCC-2	GCAUUGGUGGUUCAGUGGUAGAAUUCUCGCCUGCCACGCGGGAGGCCCGGGUUCGAUUCCCGGCCAAUGCA	71
tRNA-Gly-GCC-2-5	Gly-GCC-2	GCAUUGGUGGUUCAGUGGUAGAAUUCUCGCCUGCCACGCGGGAGGCCCGGGUUCGAUUCCCGGCCAAUGCA	71
tRNA-Gly-GCC-2-6	Gly-GCC-2	GCAUUGGUGGUUCAGUGGUAGAAUUCUCGCCUGCCACGCGGGAGGCCCGGGUUCGAUUCCCGGCCAAUGCA	71
tRNA-Gly-TCC-2-1	Gly-TCC-2	GCGUUGGUGGUAUAGUGGUGAGCAUAGCUGCCUUCCAAGCAGUUGACCCGGGUUCGAUUCCCGGCCAACGCA	72
tRNA-Gly-TCC-2-2	Gly-TCC-2	GCGUUGGUGGUAUAGUGGUGAGCAUAGCUGCCUUCCAAGCAGUUGACCCGGGUUCGAUUCCCGGCCAACGCA	72
tRNA-Gly-TCC-2-3	Gly-TCC-2	GCGUUGGUGGUAUAGUGGUGAGCAUAGCUGCCUUCCAAGCAGUUGACCCGGGUUCGAUUCCCGGCCAACGCA	72
tRNA-Gly-TCC-2-4	Gly-TCC-2	GCGUUGGUGGUAUAGUGGUGAGCAUAGCUGCCUUCCAAGCAGUUGACCCGGGUUCGAUUCCCGGCCAACGCA	72
tRNA-Gly-TCC-2-5	Gly-TCC-2	GCGUUGGUGGUAUAGUGGUGAGCAUAGCUGCCUUCCAAGCAGUUGACCCGGGUUCGAUUCCCGGCCAACGCA	72
tRNA-Gly-TCC-2-6	Gly-TCC-2	GCGUUGGUGGUAUAGUGGUGAGCAUAGCUGCCUUCCAAGCAGUUGACCCGGGUUCGAUUCCCGGCCAACGCA	72
tRNA-His-GTG-1-1	His-GTG-1	GCCGUGAUCGUAUAGUGGUUAGUACUCUGCGUUGUGGCCGCAGCAACCUCGGUUCGAAUCCGAGUCACGGCA	72
tRNA-His-GTG-1-2	His-GTG-1	GCCGUGAUCGUAUAGUGGUUAGUACUCUGCGUUGUGGCCGCAGCAACCUCGGUUCGAAUCCGAGUCACGGCA	72
tRNA-His-GTG-1-3	His-GTG-1	GCCGUGAUCGUAUAGUGGUUAGUACUCUGCGUUGUGGCCGCAGCAACCUCGGUUCGAAUCCGAGUCACGGCA	72
tRNA-His-GTG-1-4	His-GTG-1	GCCGUGAUCGUAUAGUGGUUAGUACUCUGCGUUGUGGCCGCAGCAACCUCGGUUCGAAUCCGAGUCACGGCA	72
tRNA-His-GTG-1-5	His-GTG-1	GCCGUGAUCGUAUAGUGGUUAGUACUCUGCGUUGUGGCCGCAGCAACCUCGGUUCGAAUCCGAGUCACGGCA	72
tRNA-His-GTG-1-6	His-GTG-1	GCCGUGAUCGUAUAGUGGUUAGUACUCUGCGUUGUGGCCGCAGCAACCUCGGUUCGAAUCCGAGUCACGGCA	72
tRNA-His-GTG-1-7	His-GTG-1	GCCGUGAUCGUAUAGUGGUUAGUACUCUGCGUUGUGGCCGCAGCAACCUCGGUUCGAAUCCGAGUCACGGCA	72
tRNA-His-GTG-1-8	His-GTG-1	GCCGUGAUCGUAUAGUGGUUAGUACUCUGCGUUGUGGCCGCAGCAACCUCGGUUCGAAUCCGAGUCACGGCA	72
tRNA-His-GTG-1-9	His-GTG-1	GCCGUGAUCGUAUAGUGGUUAGUACUCUGCGUUGUGGCCGCAGCAACCUCGGUUCGAAUCCGAGUCACGGCA	72
tRNA-Ile-AAT-5-1	Ile-AAT-5	GGCCGGUUAGCUCAGUUGGUUAGAGCGUGGUGCUAAUAACGCCAAGGUCGCGGGUUCGAUCCCCGUACGGGCCA	74
tRNA-Ile-AAT-5-2	Ile-AAT-5	GGCCGGUUAGCUCAGUUGGUUAGAGCGUGGUGCUAAUAACGCCAAGGUCGCGGGUUCGAUCCCCGUACGGGCCA	74
tRNA-Ile-AAT-5-3	Ile-AAT-5	GGCCGGUUAGCUCAGUUGGUUAGAGCGUGGUGCUAAUAACGCCAAGGUCGCGGGUUCGAUCCCCGUACGGGCCA	74
tRNA-Ile-AAT-5-4	Ile-AAT-5	GGCCGGUUAGCUCAGUUGGUUAGAGCGUGGUGCUAAUAACGCCAAGGUCGCGGGUUCGAUCCCCGUACGGGCCA	74
tRNA-Ile-AAT-5-5	Ile-AAT-5	GGCCGGUUAGCUCAGUUGGUUAGAGCGUGGUGCUAAUAACGCCAAGGUCGCGGGUUCGAUCCCCGUACGGGCCA	74
tRNA-Ile-AAT-7-1	Ile-AAT-7	GGCCGGUUAGCUCAGUUGGUCAGAGCGUGGUGCUAAUAACGCCAAGGUCGCGGGUUCGAUCCCCGUACGGGCCA	74
tRNA-Ile-AAT-7-2	Ile-AAT-7	GGCCGGUUAGCUCAGUUGGUCAGAGCGUGGUGCUAAUAACGCCAAGGUCGCGGGUUCGAUCCCCGUACGGGCCA	74
tRNA-Ile-GAT-1-1	Ile-GAT-1	GGCCGGUUAGCUCAGUUGGUAAGAGCGUGGUGCUGAUAACACCAAGGUCGCGGGCUCGACUCCCGCACCGGCCA	74
tRNA-Ile-GAT-1-2	Ile-GAT-1	GGCCGGUUAGCUCAGUUGGUAAGAGCGUGGUGCUGAUAACACCAAGGUCGCGGGCUCGACUCCCGCACCGGCCA	74
tRNA-Ile-GAT-1-3	Ile-GAT-1	GGCCGGUUAGCUCAGUUGGUAAGAGCGUGGUGCUGAUAACACCAAGGUCGCGGGCUCGACUCCCGCACCGGCCA	74
tRNA-Ile-TAT-2-1	Ile-TAT-2	GCUCCAGUGGCGCAAUCGGUUAGCGCGCGGUACUUAUAAUGCCGAGGUUGUGAGUUCGAGCCUCACCUGGAGCA	74
tRNA-Ile-TAT-2-2	Ile-TAT-2	GCUCCAGUGGCGCAAUCGGUUAGCGCGCGGUACUUAUAAUGCCGAGGUUGUGAGUUCGAGCCUCACCUGGAGCA	74
tRNA-Ile-TAT-2-3	Ile-TAT-2	GCUCCAGUGGCGCAAUCGGUUAGCGCGCGGUACUUAUAAUGCCGAGGUUGUGAGUUCGAGCCUCACCUGGAGCA	74
tRNA-Leu-AAG-1-1	Leu-AAG-1	GGUAGCGUGGCCGAGCGGUCUAAGGCGCUGGAUUAAGGCUCCAGUCUCUUCGGAGGCGUGGGUUCGAAUCCCACCGCUGCCA	82
tRNA-Leu-AAG-1-2	Leu-AAG-1	GGUAGCGUGGCCGAGCGGUCUAAGGCGCUGGAUUAAGGCUCCAGUCUCUUCGGAGGCGUGGGUUCGAAUCCCACCGCUGCCA	82
tRNA-Leu-AAG-1-3	Leu-AAG-1	GGUAGCGUGGCCGAGCGGUCUAAGGCGCUGGAUUAAGGCUCCAGUCUCUUCGGAGGCGUGGGUUCGAAUCCCACCGCUGCCA	82
tRNA-Leu-AAG-2-1	Leu-AAG-2	GGUAGCGUGGCCGAGCGGUCUAAGGCGCUGGAUUAAGGCUCCAGUCUCUUCGGGGGCGUGGGUUCGAAUCCCACCGCUGCCA	82
tRNA-Leu-AAG-2-2	Leu-AAG-2	GGUAGCGUGGCCGAGCGGUCUAAGGCGCUGGAUUAAGGCUCCAGUCUCUUCGGGGGCGUGGGUUCGAAUCCCACCGCUGCCA	82
tRNA-Leu-AAG-2-3	Leu-AAG-2	GGUAGCGUGGCCGAGCGGUCUAAGGCGCUGGAUUAAGGCUCCAGUCUCUUCGGGGGCGUGGGUUCGAAUCCCACCGCUGCCA	82
tRNA-Leu-AAG-2-4	Leu-AAG-2	GGUAGCGUGGCCGAGCGGUCUAAGGCGCUGGAUUAAGGCUCCAGUCUCUUCGGGGGCGUGGGUUCGAAUCCCACCGCUGCCA	82
tRNA-Leu-CAA-1-1	Leu-CAA-1	GUCAGGAUGGCCGAGUGGUCUAAGGCGCCAGACUCAAGUUCUGGUCUCCAAUGGAGGCGUGGGUUCGAAUCCCACUUCUGACA	83
tRNA-Leu-CAA-1-2	Leu-CAA-1	GUCAGGAUGGCCGAGUGGUCUAAGGCGCCAGACUCAAGUUCUGGUCUCCAAUGGAGGCGUGGGUUCGAAUCCCACUUCUGACA	83
tRNA-Leu-CAG-1-1	Leu-CAG-1	GUCAGGAUGGCCGAGCGGUCUAAGGCGCUGCGUUCAGGUCGCAGUCUCCCCUGGAGGCGUGGGUUCGAAUCCCACUCCUGACA	83
tRNA-Leu-CAG-1-2	Leu-CAG-1	GUCAGGAUGGCCGAGCGGUCUAAGGCGCUGCGUUCAGGUCGCAGUCUCCCCUGGAGGCGUGGGUUCGAAUCCCACUCCUGACA	83
tRNA-Leu-CAG-1-3	Leu-CAG-1	GUCAGGAUGGCCGAGCGGUCUAAGGCGCUGCGUUCAGGUCGCAGUCUCCCCUGGAGGCGUGGGUUCGAAUCCCACUCCUGACA	83
tRNA-Leu-CAG-1-4	Leu-CAG-1	GUCAGGAUGGCCGAGCGGUCUAAGGCGCUGCGUUCAGGUCGCAGUCUCCCCUGGAGGCGUGGGUUCGAAUCCCACUCCUGACA	83
tRNA-Leu-CAG-1-5	Leu-CAG-1	GUCAGGAUGGCCGAGCGGUCUAAGGCGCUGCGUUCAGGUCGCAGUCUCCCCUGGAGGCGUGGGUUCGAAUCCCACUCCUGACA	83
tRNA-Leu-CAG-1-6	Leu-CAG-1	GUCAGGAUGGCCGAGCGGUCUAAGGCGCUGCGUUCAGGUCGCAGUCUCCCCUGGAGGCGUGGGUUCGAAUCCCACUCCUGACA	83
tRNA-Leu-CAG-1-7	Leu-CAG-1	GUCAGGAUGGCCGAGCGGUCUAAGGCGCUGCGUUCAGGUCGCAGUCUCCCCUGGAGGCGUGGGUUCGAAUCCCACUCCUGACA	83
tRNA-Leu-CAG-2-1	Leu-CAG-2	GUCAGGAUGGCCGAGCGGUCUAAGGCGCUGCGUUCAGGUCGCAGUCUCCCCUGGAGGCGUGGGUUCGAAUCCCACUUCUGACA	83
tRNA-Leu-CAG-2-2	Leu-CAG-2	GUCAGGAUGGCCGAGCGGUCUAAGGCGCUGCGUUCAGGUCGCAGUCUCCCCUGGAGGCGUGGGUUCGAAUCCCACUUCUGACA	83
tRNA-Lys-CTT-1-1	Lys-CTT-1	GCCCGGCUAGCUCAGUCGGUAGAGCAUGGGACUCUUAAUCCCAGGGUCGUGGGUUCGAGCCCCACGUUGGGCG	73
tRNA-Lys-CTT-1-2	Lys-CTT-1	GCCCGGCUAGCUCAGUCGGUAGAGCAUGGGACUCUUAAUCCCAGGGUCGUGGGUUCGAGCCCCACGUUGGGCG	73
tRNA-Lys-CTT-2-1	Lys-CTT-2	GCCCGGCUAGCUCAGUCGGUAGAGCAUGAGACUCUUAAUCUCAGGGUCGUGGGUUCGAGCCCCACGUUGGGCG	73
tRNA-Lys-CTT-2-2	Lys-CTT-2	GCCCGGCUAGCUCAGUCGGUAGAGCAUGAGACUCUUAAUCUCAGGGUCGUGGGUUCGAGCCCCACGUUGGGCG	73
tRNA-Lys-CTT-2-3	Lys-CTT-2	GCCCGGCUAGCUCAGUCGGUAGAGCAUGAGACUCUUAAUCUCAGGGUCGUGGGUUCGAGCCCCACGUUGGGCG	73
tRNA-Lys-CTT-2-4	Lys-CTT-2	GCCCGGCUAGCUCAGUCGGUAGAGCAUGAGACUCUUAAUCUCAGGGUCGUGGGUUCGAGCCCCACGUUGGGCG	73
tRNA-Lys-CTT-2-5	Lys-CTT-2	GCCCGGCUAGCUCAGUCGGUAGAGCAUGAGACUCUUAAUCUCAGGGUCGUGGGUUCGAGCCCCACGUUGGGCG	73
tRNA-Lys-TTT-3-1	Lys-TTT-3	GCCCGGAUAGCUCAGUCGGUAGAGCAUCAGACUUUUAAUCUGAGGGUCCAGGGUUCAAGUCCCUGUUCGGGCG	73
tRNA-Lys-TTT-3-2	Lys-TTT-3	GCCCGGAUAGCUCAGUCGGUAGAGCAUCAGACUUUUAAUCUGAGGGUCCAGGGUUCAAGUCCCUGUUCGGGCG	73
tRNA-Lys-TTT-3-3	Lys-TTT-3	GCCCGGAUAGCUCAGUCGGUAGAGCAUCAGACUUUUAAUCUGAGGGUCCAGGGUUCAAGUCCCUGUUCGGGCG	73
tRNA-Lys-TTT-3-4	Lys-TTT-3	GCCCGGAUAGCUCAGUCGGUAGAGCAUCAGACUUUUAAUCUGAGGGUCCAGGGUUCAAGUCCCUGUUCGGGCG	73
tRNA-Lys-TTT-3-5	Lys-TTT-3	GCCCGGAUAGCUCAGUCGGUAGAGCAUCAGACUUUUAAUCUGAGGGUCCAGGGUUCAAGUCCCUGUUCGGGCG	73
tRNA-Met-CAT-3-1	Met-CAT-3	GCCUCCUUAGCGCAGUAGGCAGCGCGUCAGUCUCAUAAUCUGAAGGUCCUGAGUUCGAACCUCAGAGGGGGCA	73
tRNA-Met-CAT-3-2	Met-CAT-3	GCCUCCUUAGCGCAGUAGGCAGCGCGUCAGUCUCAUAAUCUGAAGGUCCUGAGUUCGAACCUCAGAGGGGGCA	73
tRNA-Met-CAT-4-1	Met-CAT-4	GCCCUCUUAGCGCAGCGGGCAGCGCGUCAGUCUCAUAAUCUGAAGGUCCUGAGUUCGAGCCUCAGAGAGGGCA	73
tRNA-Met-CAT-4-2	Met-CAT-4	GCCCUCUUAGCGCAGCGGGCAGCGCGUCAGUCUCAUAAUCUGAAGGUCCUGAGUUCGAGCCUCAGAGAGGGCA	73
tRNA-Met-CAT-4-3	Met-CAT-4	GCCCUCUUAGCGCAGCGGGCAGCGCGUCAGUCUCAUAAUCUGAAGGUCCUGAGUUCGAGCCUCAGAGAGGGCA	73
tRNA-Met-CAT-5-1	Met-CAT-5	GCCCUCUUAGCGCAGCUGGCAGCGCGUCAGUCUCAUAAUCUGAAGGUCCUGAGUUCAAGCCUCAGAGAGGGCA	73
tRNA-Met-CAT-5-2	Met-CAT-5	GCCCUCUUAGCGCAGCUGGCAGCGCGUCAGUCUCAUAAUCUGAAGGUCCUGAGUUCAAGCCUCAGAGAGGGCA	73
tRNA-Phe-GAA-1-1	Phe-GAA-1	GCCGAAAUAGCUCAGUUGGGAGAGCGUUAGACUGAAGAUCUAAAGGUCCCUGGUUCGAUCCCGGGUUUCGGCA	73
tRNA-Phe-GAA-1-2	Phe-GAA-1	GCCGAAAUAGCUCAGUUGGGAGAGCGUUAGACUGAAGAUCUAAAGGUCCCUGGUUCGAUCCCGGGUUUCGGCA	73
tRNA-Phe-GAA-1-3	Phe-GAA-1	GCCGAAAUAGCUCAGUUGGGAGAGCGUUAGACUGAAGAUCUAAAGGUCCCUGGUUCGAUCCCGGGUUUCGGCA	73
tRNA-Phe-GAA-1-4	Phe-GAA-1	GCCGAAAUAGCUCAGUUGGGAGAGCGUUAGACUGAAGAUCUAAAGGUCCCUGGUUCGAUCCCGGGUUUCGGCA	73
tRNA-Phe-GAA-1-5	Phe-GAA-1	GCCGAAAUAGCUCAGUUGGGAGAGCGUUAGACUGAAGAUCUAAAGGUCCCUGGUUCGAUCCCGGGUUUCGGCA	73
tRNA-Phe-GAA-1-6	Phe-GAA-1	GCCGAAAUAGCUCAGUUGGGAGAGCGUUAGACUGAAGAUCUAAAGGUCCCUGGUUCGAUCCCGGGUUUCGGCA	73
tRNA-Pro-AGG-2-1	Pro-AGG-2	GGCUCGUUGGUCUAGGGGUAUGAUUCUCGCUUAGGGUGCGAGAGGUCCCGGGUUCAAAUCCCGGACGAGCCC	72
tRNA-Pro-AGG-2-2	Pro-AGG-2	GGCUCGUUGGUCUAGGGGUAUGAUUCUCGCUUAGGGUGCGAGAGGUCCCGGGUUCAAAUCCCGGACGAGCCC	72
tRNA-Pro-AGG-2-3	Pro-AGG-2	GGCUCGUUGGUCUAGGGGUAUGAUUCUCGCUUAGGGUGCGAGAGGUCCCGGGUUCAAAUCCCGGACGAGCCC	72
tRNA-Pro-AGG-2-4	Pro-AGG-2	GGCUCGUUGGUCUAGGGGUAUGAUUCUCGCUUAGGGUGCGAGAGGUCCCGGGUUCAAAUCCCGGACGAGCCC	72
tRNA-Pro-AGG-2-5	Pro-AGG-2	GGCUCGUUGGUCUAGGGGUAUGAUUCUCGCUUAGGGUGCGAGAGGUCCCGGGUUCAAAUCCCGGACGAGCCC	72
tRNA-Pro-AGG-2-6	Pro-AGG-2	GGCUCGUUGGUCUAGGGGUAUGAUUCUCGCUUAGGGUGCGAGAGGUCCCGGGUUCAAAUCCCGGACGAGCCC	72
tRNA-Pro-AGG-2-7	Pro-AGG-2	GGCUCGUUGGUCUAGGGGUAUGAUUCUCGCUUAGGGUGCGAGAGGUCCCGGGUUCAAAUCCCGGACGAGCCC	72
tRNA-Pro-AGG-2-8	Pro-AGG-2	GGCUCGUUGGUCUAGGGGUAUGAUUCUCGCUUAGGGUGCGAGAGGUCCCGGGUUCAAAUCCCGGACGAGCCC	72
tRNA-Pro-CGG-1-1	Pro-CGG-1	GGCUCGUUGGUCUAGGGGUAUGAUUCUCGCUUCGGGUGCGAGAGGUCCCGGGUUCAAAUCCCGGACGAGCCC	72
tRNA-Pro-CGG-1-2	Pro-CGG-1	GGCUCGUUGGUCUAGGGGUAUGAUUCUCGCUUCGGGUGCGAGAGGUCCCGGGUUCAAAUCCCGGACGAGCCC	72
tRNA-Pro-CGG-1-3	Pro-CGG-1	GGCUCGUUGGUCUAGGGGUAUGAUUCUCGCUUCGGGUGCGAGAGGUCCCGGGUUCAAAUCCCGGACGAGCCC	72
tRNA-Pro-TGG-3-1	Pro-TGG-3	GGCUCGUUGGUCUAGGGGUAUGAUUCUCGCUUUGGGUGCGAGAGGUCCCGGGUUCAAAUCCCGGACGAGCCC	72
tRNA-Pro-TGG-3-2	Pro-TGG-3	GGCUCGUUGGUCUAGGGGUAUGAUUCUCGCUUUGGGUGCGAGAGGUCCCGGGUUCAAAUCCCGGACGAGCCC	72
tRNA-Pro-TGG-3-3	Pro-TGG-3	GGCUCGUUGGUCUAGGGGUAUGAUUCUCGCUUUGGGUGCGAGAGGUCCCGGGUUCAAAUCCCGGACGAGCCC	72
tRNA-Pro-TGG-3-4	Pro-TGG-3	GGCUCGUUGGUCUAGGGGUAUGAUUCUCGCUUUGGGUGCGAGAGGUCCCGGGUUCAAAUCCCGGACGAGCCC	72
tRNA-Pro-TGG-3-5	Pro-TGG-3	GGCUCGUUGGUCUAGGGGUAUGAUUCUCGCUUUGGGUGCGAGAGGUCCCGGGUUCAAAUCCCGGACGAGCCC	72
tRNA-Ser-AGA-2-1	Ser-AGA-2	GUAGUCGUGGCCGAGUGGUUAAGGCGAUGGACUAGAAAUCCAUUGGGGUCUCCCCGCGCAGGUUCGAAUCCUGCCGACUACG	82
tRNA-Ser-AGA-2-2	Ser-AGA-2	GUAGUCGUGGCCGAGUGGUUAAGGCGAUGGACUAGAAAUCCAUUGGGGUCUCCCCGCGCAGGUUCGAAUCCUGCCGACUACG	82
tRNA-Ser-AGA-2-3	Ser-AGA-2	GUAGUCGUGGCCGAGUGGUUAAGGCGAUGGACUAGAAAUCCAUUGGGGUCUCCCCGCGCAGGUUCGAAUCCUGCCGACUACG	82
tRNA-Ser-AGA-2-4	Ser-AGA-2	GUAGUCGUGGCCGAGUGGUUAAGGCGAUGGACUAGAAAUCCAUUGGGGUCUCCCCGCGCAGGUUCGAAUCCUGCCGACUACG	82
tRNA-Ser-AGA-2-5	Ser-AGA-2	GUAGUCGUGGCCGAGUGGUUAAGGCGAUGGACUAGAAAUCCAUUGGGGUCUCCCCGCGCAGGUUCGAAUCCUGCCGACUACG	82
tRNA-Ser-AGA-2-6	Ser-AGA-2	GUAGUCGUGGCCGAGUGGUUAAGGCGAUGGACUAGAAAUCCAUUGGGGUCUCCCCGCGCAGGUUCGAAUCCUGCCGACUACG	82
tRNA-Ser-GCT-4-1	Ser-GCT-4	GACGAGGUGGCCGAGUGGUUAAGGCGAUGGACUGCUAAUCCAUUGUGCUCUGCACGCGUGGGUUCGAAUCCCAUCCUCGUCG	82
tRNA-Ser-GCT-4-2	Ser-GCT-4	GACGAGGUGGCCGAGUGGUUAAGGCGAUGGACUGCUAAUCCAUUGUGCUCUGCACGCGUGGGUUCGAAUCCCAUCCUCGUCG	82
tRNA-Ser-GCT-4-3	Ser-GCT-4	GACGAGGUGGCCGAGUGGUUAAGGCGAUGGACUGCUAAUCCAUUGUGCUCUGCACGCGUGGGUUCGAAUCCCAUCCUCGUCG	82
tRNA-Thr-AGT-1-1	Thr-AGT-1	GGCGCCGUGGCUUAGUUGGUUAAAGCGCCUGUCUAGUAAACAGGAGAUCCUGGGUUCGAAUCCCAGCGGUGCCU	74
tRNA-Thr-AGT-1-2	Thr-AGT-1	GGCGCCGUGGCUUAGUUGGUUAAAGCGCCUGUCUAGUAAACAGGAGAUCCUGGGUUCGAAUCCCAGCGGUGCCU	74
tRNA-Thr-AGT-1-3	Thr-AGT-1	GGCGCCGUGGCUUAGUUGGUUAAAGCGCCUGUCUAGUAAACAGGAGAUCCUGGGUUCGAAUCCCAGCGGUGCCU	74
tRNA-Thr-AGT-2-1	Thr-AGT-2	GGCUCCGUGGCUUAGCUGGUUAAAGCGCCUGUCUAGUAAACAGGAGAUCCUGGGUUCGAAUCCCAGCGGGGCCU	74
tRNA-Thr-AGT-2-2	Thr-AGT-2	GGCUCCGUGGCUUAGCUGGUUAAAGCGCCUGUCUAGUAAACAGGAGAUCCUGGGUUCGAAUCCCAGCGGGGCCU	74
tRNA-Trp-CCA-3-1	Trp-CCA-3	GACCUCGUGGCGCAACGGUAGCGCGUCUGACUCCAGAUCAGAAGGUUGCGUGUUCAAAUCACGUCGGGGUCA	72
tRNA-Trp-CCA-3-2	Trp-CCA-3	GACCUCGUGGCGCAACGGUAGCGCGUCUGACUCCAGAUCAGAAGGUUGCGUGUUCAAAUCACGUCGGGGUCA	72
tRNA-Trp-CCA-3-3	Trp-CCA-3	GACCUCGUGGCGCAACGGUAGCGCGUCUGACUCCAGAUCAGAAGGUUGCGUGUUCAAAUCACGUCGGGGUCA	72
tRNA-Tyr-GTA-5-1	Tyr-GTA-5	CCUUCGAUAGCUCAGCUGGUAGAGCGGAGGACUGUAGAUCCUUAGGUCGCUGGUUCGAUUCCGGCUCGAAGGA	73
tRNA-Tyr-GTA-5-2	Tyr-GTA-5	CCUUCGAUAGCUCAGCUGGUAGAGCGGAGGACUGUAGAUCCUUAGGUCGCUGGUUCGAUUCCGGCUCGAAGGA	73
tRNA-Tyr-GTA-5-3	Tyr-GTA-5	CCUUCGAUAGCUCAGCUGGUAGAGCGGAGGACUGUAGAUCCUUAGGUCGCUGGUUCGAUUCCGGCUCGAAGGA	73
tRNA-Tyr-GTA-5-4	Tyr-GTA-5	CCUUCGAUAGCUCAGCUGGUAGAGCGGAGGACUGUAGAUCCUUAGGUCGCUGGUUCGAUUCCGGCUCGAAGGA	73
tRNA-Tyr-GTA-5-5	Tyr-GTA-5	CCUUCGAUAGCUCAGCUGGUAGAGCGGAGGACUGUAGAUCCUUAGGUCGCUGGUUCGAUUCCGGCUCGAAGGA	73
tRNA-Val-AAC-1-1	Val-AAC-1	GUUUCCGUAGUGUAGUGGUUAUCACGUUCGCCUAACACGCGAAAGGUCCCCGGUUCGAAACCGGGCGGAAACA	73
tRNA-Val-AAC-1-2	Val-AAC-1	GUUUCCGUAGUGUAGUGGUUAUCACGUUCGCCUAACACGCGAAAGGUCCCCGGUUCGAAACCGGGCGGAAACA	73
tRNA-Val-AAC-1-3	Val-AAC-1	GUUUCCGUAGUGUAGUGGUUAUCACGUUCGCCUAACACGCGAAAGGUCCCCGGUUCGAAACCGGGCGGAAACA	73
tRNA-Val-AAC-1-4	Val-AAC-1	GUUUCCGUAGUGUAGUGGUUAUCACGUUCGCCUAACACGCGAAAGGUCCCCGGUUCGAAACCGGGCGGAAACA	73
tRNA-Val-AAC-1-5	Val-AAC-1	GUUUCCGUAGUGUAGUGGUUAUCACGUUCGCCUAACACGCGAAAGGUCCCCGGUUCGAAACCGGGCGGAAACA	73
tRNA-Val-CAC-1-1	Val-CAC-1	GUUUCCGUAGUGUAGUGGUUAUCACGUUCGCCUCACACGCGAAAGGUCCCCGGUUCGAAACCGGGCGGAAACA	73
tRNA-Val-CAC-1-2	Val-CAC-1	GUUUCCGUAGUGUAGUGGUUAUCACGUUCGCCUCACACGCGAAAGGUCCCCGGUUCGAAACCGGGCGGAAACA	73
tRNA-Val-CAC-1-3	Val-CAC-1	GUUUCCGUAGUGUAGUGGUUAUCACGUUCGCCUCACACGCGAAAGGUCCCCGGUUCGAAACCGGGCGGAAACA	73
tRNA-Val-CAC-1-4	Val-CAC-1	GUUUCCGUAGUGUAGUGGUUAUCACGUUCGCCUCACACGCGAAAGGUCCCCGGUUCGAAACCGGGCGGAAACA	73
tRNA-Val-CAC-1-5	Val-CAC-1	GUUUCCGUAGUGUAGUGGUUAUCACGUUCGCCUCACACGCGAAAGGUCCCCGGUUCGAAACCGGGCGGAAACA	73
tRNA-Val-CAC-1-6	Val-CAC-1	GUUUCCGUAGUGUAGUGGUUAUCACGUUCGCCUCACACGCGAAAGGUCCCCGGUUCGAAACCGGGCGGAAACA	73
tRNA-Val-CAC-1-7	Val-CAC-1	GUUUCCGUAGUGUAGUGGUUAUCACGUUCGCCUCACACGCGAAAGGUCCCCGGUUCGAAACCGGGCGGAAACA	73
tRNA-Val-CAC-5-1	Val-CAC-5	GUUUCCGUAGUGUAGUGGUUAUCACGUUCGCCUCACACGCGAAAGGUCCCCGGUUCGAAACCGGGCGGAAACA	73
tRNA-Val-TAC-1-1	Val-TAC-1	GGUUCCAUAGUGUAGUGGUUAUCACGUCUGCUUUACACGCAGAAGGUCCUGGGUUCGAGCCCCAGUGGAACCA	73
tRNA-Val-TAC-1-2	Val-TAC-1	GGUUCCAUAGUGUAGUGGUUAUCACGUCUGCUUUACACGCAGAAGGUCCUGGGUUCGAGCCCCAGUGGAACCA	73
tRNA-iMet-CAT-1-1	iMet-CAT-1	AGCAGAGUGGCGCAGCGGAAGCGUGCUGGGCCCAUAACCCAGAGGUCGAUGGAUCGAAACCAUCCUCUGCUA	72
tRNA-iMet-CAT-1-2	iMet-CAT-1	AGCAGAGUGGCGCAGCGGAAGCGUGCUGGGCCCAUAACCCAGAGGUCGAUGGAUCGAAACCAUCCUCUGCUA	72
tRNA-iMet-CAT-1-3	iMet-CAT-1	AGCAGAGUGGCGCAGCGGAAGCGUGCUGGGCCCAUAACCCAGAGGUCGAUGGAUCGAAACCAUCCUCUGCUA	72
tRNA-iMet-CAT-1-4	iMet-CAT-1	AGCAGAGUGGCGCAGCGGAAGCGUGCUGGGCCCAUAACCCAGAGGUCGAUGGAUCGAAACCAUCCUCUGCUA	72
tRNA-iMet-CAT-1-5	iMet-CAT-1	AGCAGAGUGGCGCAGCGGAAGCGUGCUGGGCCCAUAACCCAGAGGUCGAUGGAUCGAAACCAUCCUCUGCUA	72
tRNA-iMet-CAT-1-6	iMet-CAT-1	AGCAGAGUGGCGCAGCGGAAGCGUGCUGGGCCCAUAACCCAGAGGUCGAUGGAUCGAAACCAUCCUCUGCUA	72
tRNA-iMet-CAT-1-7	iMet-CAT-1	AGCAGAGUGGCGCAGCGGAAGCGUGCUGGGCCCAUAACCCAGAGGUCGAUGGAUCGAAACCAUCCUCUGCUA	72
tRNA-iMet-CAT-1-8	iMet-CAT-1	AGCAGAGUGGCGCAGCGGAAGCGUGCUGGGCCCAUAACCCAGAGGUCGAUGGAUCGAAACCAUCCUCUGCUA	72
