iso	seq	len
tRNA-Ala-AGC-2-1	Ala-AGC-2	GGGGGUGUAGCUCAGUGGUAGAGCGCGUGCUUAGCAUGCACGAGGCCCCGGGUUCAAUCCCCGGCACCUCCA	72
tRNA-Ala-AGC-2-2	Ala-AGC-2	GGGGGUGUAGCUCAGUGGUAGAGCGCGUGCUUAGCAUGCACGAGGCCCCGGGUUCAAUCCCCGGCACCUCCA	72
tRNA-Ala-AGC-4-1	Ala-AGC-4	GGGGGAUUAGCUCAAAUGGUAGAGCGCUCGCUUAGCAUGCGAGAGGUAGCGGGAUCGAUGCCCGCAUCCUCCA	73
tRNA-Ala-AGC-4-2	Ala-AGC-4	GGGGGAUUAGCUCAAAUGGUAGAGCGCUCGCUUAGCAUGCGAGAGGUAGCGGGAUCGAUGCCCGCAUCCUCCA	73
tRNA-Ala-AGC-5-1	Ala-AGC-5	GGGGGAUUAGCUCAAAUGGUAGAGCGCUCGCUUAGCAUGCGAGAGGUAGUGGGAUCGAUGCCCACAUCCUCCA	73
tRNA-Ala-AGC-5-2	Ala-AGC-5	GGGGGAUUAGCUCAAAUGGUAGAGCGCUCGCUUAGCAUGCGAGAGGUAGUGGGAUCGAUGCCCACAUCCUCCA	73
tRNA-Ala-AGC-5-3	Ala-AGC-5	GGGGGAUUAGCUCAAAUGGUAGAGCGCUCGCUUAGCAUGCGAGAGGUAGUGGGAUCGAUGCCCACAUCCUCCA	73
tRNA-Ala-CGC-1-1	Ala-CGC-1	GGGGAUGUAGCUCAGUGGUAGAGCGCAUGCUUCGCAUGUAUGAGGCCCCGGGUUCGAUCCCCGGCAUCUCCA	72
tRNA-Ala-CGC-1-2	Ala-CGC-1	GGGGAUGUAGCUCAGUGGUAGAGCGCAUGCUUCGCAUGUAUGAGGCCCCGGGUUCGAUCCCCGGCAUCUCCA	72
tRNA-Ala-CGC-3-1	Ala-CGC-3	GGGGAUGUAGCUCAGAGGUAGAGCACAUGCUUCGCAUGUGUGUGGUCCCGGGUUCGACUCCCGGCAUCUCCA	72
tRNA-Ala-CGC-3-2	Ala-CGC-3	GGGGAUGUAGCUCAGAGGUAGAGCACAUGCUUCGCAUGUGUGUGGUCCCGGGUUCGACUCCCGGCAUCUCCA	72
tRNA-Ala-CGC-3-3	Ala-CGC-3	GGGGAUGUAGCUCAGAGGUAGAGCACAUGCUUCGCAUGUGUGUGGUCCCGGGUUCGACUCCCGGCAUCUCCA	72
tRNA-Ala-TGC-2-1	Ala-TGC-2	GGGGAUGUAGCUCAGUGGUAGAGCGCAUGCUUUGCAUGUAUGAGGCCCCGGGUUCGAUCCCCGGCAUCUCCA	72
tRNA-Ala-TGC-3-1	Ala-TGC-3	GGGGAUGUAGCUCAGUGGUAGAGCGCAUGCUUUGCAUGUAUGAGGCCCCGGGUUCGAUCCCCGGCAUCUCCA	72
tRNA-Ala-TGC-5-1	Ala-TGC-5	GGGGAUGUAGCUCAGCGGUAGAGCACAUGCUUUGCAUGUAUGGGGUCCCGGGUUCGAUUCCCGGCAUCUCCA	72
tRNA-Ala-TGC-5-2	Ala-TGC-5	GGGGAUGUAGCUCAGCGGUAGAGCACAUGCUUUGCAUGUAUGGGGUCCCGGGUUCGAUUCCCGGCAUCUCCA	72
tRNA-Ala-TGC-5-3	Ala-TGC-5	GGGGAUGUAGCUCAGCGGUAGAGCACAUGCUUUGCAUGUAUGGGGUCCCGGGUUCGAUUCCCGGCAUCUCCA	72
tRNA-Ala-TGC-7-1	Ala-TGC-7	GGGGAUGUAGCUCAGUGGUAGAGCACAUGCUUUGCAUGUAUGGGGUCCUGGGUUCGAUUCCCGGCAUCUCCA	72
tRNA-Ala-TGC-7-2	Ala-TGC-7	GGGGAUGUAGCUCAGUGGUAGAGCACAUGCUUUGCAUGUAUGGGGUCCUGGGUUCGAUUCCCGGCAUCUCCA	72
tRNA-Arg-ACG-1-1	Arg-ACG-1	GGGCCAGUGGCGCAAUGGAUAACGCGUCUGACUACGGAUCAGAAGAUUCCAGGUUCGACUCCUGGCUGGCUCG	73
tRNA-Arg-ACG-1-2	Arg-ACG-1	GGGCCAGUGGCGCAAUGGAUAACGCGUCUGACUACGGAUCAGAAGAUUCCAGGUUCGACUCCUGGCUGGCUCG	73
tRNA-Arg-ACG-1-3	Arg-ACG-1	GGGCCAGUGGCGCAAUGGAUAACGCGUCUGACUACGGAUCAGAAGAUUCCAGGUUCGACUCCUGGCUGGCUCG	73
tRNA-Arg-ACG-3-1	Arg-ACG-3	GGGCCAGUGGCGCAAUGGAUAACGCGUCUGACUACGGAUCAGAAGAUUCUAGGUUCGACUCCUGGCUGGCUCG	73
tRNA-Arg-ACG-3-2	Arg-ACG-3	GGGCCAGUGGCGCAAUGGAUAACGCGUCUGACUACGGAUCAGAAGAUUCUAGGUUCGACUCCUGGCUGGCUCG	73
tRNA-Arg-CCT-2-1	Arg-CCT-2	GCCCCAGUGGCCUAAUGGAUAAGGCACUGGCCUCCUAAGCCAGGGAUUGUGGGUUCGAGUCCCACCUGGGGUG	73
tRNA-Arg-CCT-2-2	Arg-CCT-2	GCCCCAGUGGCCUAAUGGAUAAGGCACUGGCCUCCUAAGCCAGGGAUUGUGGGUUCGAGUCCCACCUGGGGUG	73
tRNA-Arg-TCG-3-1	Arg-TCG-3	GACCACGUGGCCUAAUGGAUAAGGCGUCUGACUUCGGAUCAGAAGAUUGAGGGUUCGAAUCCCUUCGUGGUUG	73
tRNA-Arg-TCG-3-2	Arg-TCG-3	GACCACGUGGCCUAAUGGAUAAGGCGUCUGACUUCGGAUCAGAAGAUUGAGGGUUCGAAUCCCUUCGUGGUUG	73
tRNA-Asn-GTT-3-1	Asn-GTT-3	GUCUCUGUGGCGCAAUCGGUUAGCGCGUUCGGCUGUUAACCGAAAGGUUGGUGGUUCGAGCCCACCCAGGGACG	74
tRNA-Asn-GTT-3-2	Asn-GTT-3	GUCUCUGUGGCGCAAUCGGUUAGCGCGUUCGGCUGUUAACCGAAAGGUUGGUGGUUCGAGCCCACCCAGGGACG	74
tRNA-Asn-GTT-3-3	Asn-GTT-3	GUCUCUGUGGCGCAAUCGGUUAGCGCGUUCGGCUGUUAACCGAAAGGUUGGUGGUUCGAGCCCACCCAGGGACG	74
tRNA-Asn-GTT-3-4	Asn-GTT-3	GUCUCUGUGGCGCAAUCGGUUAGCGCGUUCGGCUGUUAACCGAAAGGUUGGUGGUUCGAGCCCACCCAGGGACG	74
tRNA-Asn-GTT-3-5	Asn-GTT-3	GUCUCUGUGGCGCAAUCGGUUAGCGCGUUCGGCUGUUAACCGAAAGGUUGGUGGUUCGAGCCCACCCAGGGACG	74
tRNA-Asn-GTT-3-6	Asn-GTT-3	GUCUCUGUGGCGCAAUCGGUUAGCGCGUUCGGCUGUUAACCGAAAGGUUGGUGGUUCGAGCCCACCCAGGGACG	74
tRNA-Asn-GTT-3-7	Asn-GTT-3	GUCUCUGUGGCGCAAUCGGUUAGCGCGUUCGGCUGUUAACCGAAAGGUUGGUGGUUCGAGCCCACCCAGGGACG	74
tRNA-Asn-GTT-3-8	Asn-GTT-3	GUCUCUGUGGCGCAAUCGGUUAGCGCGUUCGGCUGUUAACCGAAAGGUUGGUGGUUCGAGCCCACCCAGGGACG	74
tRNA-Asn-GTT-3-9	Asn-GTT-3	GUCUCUGUGGCGCAAUCGGUUAGCGCGUUCGGCUGUUAACCGAAAGGUUGGUGGUUCGAGCCCACCCAGGGACG	74
tRNA-Asp-GTC-1-1	Asp-GTC-1	UCCUCGUUAGUAUAGUGGUGAGUAUCCCCGCCUGUCACGCGGGAGACCGGGGUUCGAUUCCCCGACGGGGAG	72
tRNA-Asp-GTC-1-10	Asp-GTC-1	UCCUCGUUAGUAUAGUGGUGAGUAUCCCCGCCUGUCACGCGGGAGACCGGGGUUCGAUUCCCCGACGGGGAG	72
tRNA-Asp-GTC-1-11	Asp-GTC-1	UCCUCGUUAGUAUAGUGGUGAGUAUCCCCGCCUGUCACGCGGGAGACCGGGGUUCGAUUCCCCGACGGGGAG	72
tRNA-Asp-GTC-1-12	Asp-GTC-1	UCCUCGUUAGUAUAGUGGUGAGUAUCCCCGCCUGUCACGCGGGAGACCGGGGUUCGAUUCCCCGACGGGGAG	72
tRNA-Asp-GTC-1-13	Asp-GTC-1	UCCUCGUUAGUAUAGUGGUGAGUAUCCCCGCCUGUCACGCGGGAGACCGGGGUUCGAUUCCCCGACGGGGAG	72
tRNA-Asp-GTC-1-2	Asp-GTC-1	UCCUCGUUAGUAUAGUGGUGAGUAUCCCCGCCUGUCACGCGGGAGACCGGGGUUCGAUUCCCCGACGGGGAG	72
tRNA-Asp-GTC-1-3	Asp-GTC-1	UCCUCGUUAGUAUAGUGGUGAGUAUCCCCGCCUGUCACGCGGGAGACCGGGGUUCGAUUCCCCGACGGGGAG	72
tRNA-Asp-GTC-1-4	Asp-GTC-1	UCCUCGUUAGUAUAGUGGUGAGUAUCCCCGCCUGUCACGCGGGAGACCGGGGUUCGAUUCCCCGACGGGGAG	72
tRNA-Asp-GTC-1-5	Asp-GTC-1	UCCUCGUUAGUAUAGUGGUGAGUAUCCCCGCCUGUCACGCGGGAGACCGGGGUUCGAUUCCCCGACGGGGAG	72
tRNA-Asp-GTC-1-6	Asp-GTC-1	UCCUCGUUAGUAUAGUGGUGAGUAUCCCCGCCUGUCACGCGGGAGACCGGGGUUCGAUUCCCCGACGGGGAG	72
tRNA-Asp-GTC-1-7	Asp-GTC-1	UCCUCGUUAGUAUAGUGGUGAGUAUCCCCGCCUGUCACGCGGGAGACCGGGGUUCGAUUCCCCGACGGGGAG	72
tRNA-Asp-GTC-1-8	Asp-GTC-1	UCCUCGUUAGUAUAGUGGUGAGUAUCCCCGCCUGUCACGCGGGAGACCGGGGUUCGAUUCCCCGACGGGGAG	72
tRNA-Asp-GTC-1-9	Asp-GTC-1	UCCUCGUUAGUAUAGUGGUGAGUAUCCCCGCCUGUCACGCGGGAGACCGGGGUUCGAUUCCCCGACGGGGAG	72
tRNA-Cys-GCA-1-1	Cys-GCA-1	GGGGGUAUAGCUCAGUGGUAGAGCAUUUGACUGCAGAUCAAGAGGUCCCUGGUUCAAAUCCAGGUGCCCCCU	72
tRNA-Cys-GCA-1-2	Cys-GCA-1	GGGGGUAUAGCUCAGUGGUAGAGCAUUUGACUGCAGAUCAAGAGGUCCCUGGUUCAAAUCCAGGUGCCCCCU	72
tRNA-Cys-GCA-3-1	Cys-GCA-3	GGGGGUAUAGCUCAGUGGUAGAGCAUUUGACUGCAGAUCAAGAGGUCCCCGGUUCAAAUCCGGGUGCCCCCU	72
tRNA-Cys-GCA-3-2	Cys-GCA-3	GGGGGUAUAGCUCAGUGGUAGAGCAUUUGACUGCAGAUCAAGAGGUCCCCGGUUCAAAUCCGGGUGCCCCCU	72
tRNA-Cys-GCA-3-3	Cys-GCA-3	GGGGGUAUAGCUCAGUGGUAGAGCAUUUGACUGCAGAUCAAGAGGUCCCCGGUUCAAAUCCGGGUGCCCCCU	72
tRNA-Cys-GCA-3-4	Cys-GCA-3	GGGGGUAUAGCUCAGUGGUAGAGCAUUUGACUGCAGAUCAAGAGGUCCCCGGUUCAAAUCCGGGUGCCCCCU	72
tRNA-Cys-GCA-4-1	Cys-GCA-4	GGGGGUAUAGCUCAGGGGUAGAGCAUUUGACUGCAGAUCAAGAGGUCCCUGGUUCAAAUCCAGGUGCCCCCU	72
tRNA-Cys-GCA-4-10	Cys-GCA-4	GGGGGUAUAGCUCAGGGGUAGAGCAUUUGACUGCAGAUCAAGAGGUCCCUGGUUCAAAUCCAGGUGCCCCCU	72
tRNA-Cys-GCA-4-11	Cys-GCA-4	GGGGGUAUAGCUCAGGGGUAGAGCAUUUGACUGCAGAUCAAGAGGUCCCUGGUUCAAAUCCAGGUGCCCCCU	72
tRNA-Cys-GCA-4-12	Cys-GCA-4	GGGGGUAUAGCUCAGGGGUAGAGCAUUUGACUGCAGAUCAAGAGGUCCCUGGUUCAAAUCCAGGUGCCCCCU	72
tRNA-Cys-GCA-4-13	Cys-GCA-4	GGGGGUAUAGCUCAGGGGUAGAGCAUUUGACUGCAGAUCAAGAGGUCCCUGGUUCAAAUCCAGGUGCCCCCU	72
tRNA-Cys-GCA-4-14	Cys-GCA-4	GGGGGUAUAGCUCAGGGGUAGAGCAUUUGACUGCAGAUCAAGAGGUCCCUGGUUCAAAUCCAGGUGCCCCCU	72
tRNA-Cys-GCA-4-15	Cys-GCA-4	GGGGGUAUAGCUCAGGGGUAGAGCAUUUGACUGCAGAUCAAGAGGUCCCUGGUUCAAAUCCAGGUGCCCCCU	72
tRNA-Cys-GCA-4-16	Cys-GCA-4	GGGGGUAUAGCUCAGGGGUAGAGCAUUUGACUGCAGAUCAAGAGGUCCCUGGUUCAAAUCCAGGUGCCCCCU	72
tRNA-Cys-GCA-4-17	Cys-GCA-4	GGGGGUAUAGCUCAGGGGUAGAGCAUUUGACUGCAGAUCAAGAGGUCCCUGGUUCAAAUCCAGGUGCCCCCU	72
tRNA-Cys-GCA-4-18	Cys-GCA-4	GGGGGUAUAGCUCAGGGGUAGAGCAUUUGACUGCAGAUCAAGAGGUCCCUGGUUCAAAUCCAGGUGCCCCCU	72
tRNA-Cys-GCA-4-19	Cys-GCA-4	GGGGGUAUAGCUCAGGGGUAGAGCAUUUGACUGCAGAUCAAGAGGUCCCUGGUUCAAAUCCAGGUGCCCCCU	72
tRNA-Cys-GCA-4-2	Cys-GCA-4	GGGGGUAUAGCUCAGGGGUAGAGCAUUUGACUGCAGAUCAAGAGGUCCCUGGUUCAAAUCCAGGUGCCCCCU	72
tRNA-Cys-GCA-4-20	Cys-GCA-4	GGGGGUAUAGCUCAGGGGUAGAGCAUUUGACUGCAGAUCAAGAGGUCCCUGGUUCAAAUCCAGGUGCCCCCU	72
tRNA-Cys-GCA-4-21	Cys-GCA-4	GGGGGUAUAGCUCAGGGGUAGAGCAUUUGACUGCAGAUCAAGAGGUCCCUGGUUCAAAUCCAGGUGCCCCCU	72
tRNA-Cys-GCA-4-22	Cys-GCA-4	GGGGGUAUAGCUCAGGGGUAGAGCAUUUGACUGCAGAUCAAGAGGUCCCUGGUUCAAAUCCAGGUGCCCCCU	72
tRNA-Cys-GCA-4-23	Cys-GCA-4	GGGGGUAUAGCUCAGGGGUAGAGCAUUUGACUGCAGAUCAAGAGGUCCCUGGUUCAAAUCCAGGUGCCCCCU	72
tRNA-Cys-GCA-4-24	Cys-GCA-4	GGGGGUAUAGCUCAGGGGUAGAGCAUUUGACUGCAGAUCAAGAGGUCCCUGGUUCAAAUCCAGGUGCCCCCU	72
tRNA-Cys-GCA-4-25	Cys-GCA-4	GGGGGUAUAGCUCAGGGGUAGAGCAUUUGACUGCAGAUCAAGAGGUCCCUGGUUCAAAUCCAGGUGCCCCCU	72
tRNA-Cys-GCA-4-26	Cys-GCA-4	GGGGGUAUAGCUCAGGGGUAGAGCAUUUGACUGCAGAUCAAGAGGUCCCUGGUUCAAAUCCAGGUGCCCCCU	72
tRNA-Cys-GCA-4-27	Cys-GCA-4	GGGGGUAUAGCUCAGGGGUAGAGCAUUUGACUGCAGAUCAAGAGGUCCCUGGUUCAAAUCCAGGUGCCCCCU	72
tRNA-Cys-GCA-4-28	Cys-GCA-4	GGGGGUAUAGCUCAGGGGUAGAGCAUUUGACUGCAGAUCAAGAGGUCCCUGGUUCAAAUCCAGGUGCCCCCU	72
tRNA-Cys-GCA-4-29	Cys-GCA-4	GGGGGUAUAGCUCAGGGGUAGAGCAUUUGACUGCAGAUCAAGAGGUCCCUGGUUCAAAUCCAGGUGCCCCCU	72
tRNA-Cys-GCA-4-3	Cys-GCA-4	GGGGGUAUAGCUCAGGGGUAGAGCAUUUGACUGCAGAUCAAGAGGUCCCUGGUUCAAAUCCAGGUGCCCCCU	72
tRNA-Cys-GCA-4-4	Cys-GCA-4	GGGGGUAUAGCUCAGGGGUAGAGCAUUUGACUGCAGAUCAAGAGGUCCCUGGUUCAAAUCCAGGUGCCCCCU	72
tRNA-Cys-GCA-4-5	Cys-GCA-4	GGGGGUAUAGCUCAGGGGUAGAGCAUUUGACUGCAGAUCAAGAGGUCCCUGGUUCAAAUCCAGGUGCCCCCU	72
tRNA-Cys-GCA-4-6	Cys-GCA-4	GGGGGUAUAGCUCAGGGGUAGAGCAUUUGACUGCAGAUCAAGAGGUCCCUGGUUCAAAUCCAGGUGCCCCCU	72
tRNA-Cys-GCA-4-7	Cys-GCA-4	GGGGGUAUAGCUCAGGGGUAGAGCAUUUGACUGCAGAUCAAGAGGUCCCUGGUUCAAAUCCAGGUGCCCCCU	72
tRNA-Cys-GCA-4-8	Cys-GCA-4	GGGGGUAUAGCUCAGGGGUAGAGCAUUUGACUGCAGAUCAAGAGGUCCCUGGUUCAAAUCCAGGUGCCCCCU	72
tRNA-Cys-GCA-4-9	Cys-GCA-4	GGGGGUAUAGCUCAGGGGUAGAGCAUUUGACUGCAGAUCAAGAGGUCCCUGGUUCAAAUCCAGGUGCCCCCU	72
tRNA-Gln-CTG-2-1	Gln-CTG-2	GGUUCCAUGGUGUAAUGGUUAGCACUCUGGACUCUGAAUCCAGCGAUCCGAGUUCAAAUCUCGGUGGAACCU	72
tRNA-Gln-CTG-2-2	Gln-CTG-2	GGUUCCAUGGUGUAAUGGUUAGCACUCUGGACUCUGAAUCCAGCGAUCCGAGUUCAAAUCUCGGUGGAACCU	72
tRNA-Gln-CTG-2-3	Gln-CTG-2	GGUUCCAUGGUGUAAUGGUUAGCACUCUGGACUCUGAAUCCAGCGAUCCGAGUUCAAAUCUCGGUGGAACCU	72
tRNA-Gln-CTG-2-4	Gln-CTG-2	GGUUCCAUGGUGUAAUGGUUAGCACUCUGGACUCUGAAUCCAGCGAUCCGAGUUCAAAUCUCGGUGGAACCU	72
tRNA-Gln-CTG-3-1	Gln-CTG-3	GGUUCCAUGGUGUAAUGGUUAGCACUCUGGACUCUGAAUCCAGCGAUCCGAGUUCAAAUCUCGGUGGGACCU	72
tRNA-Gln-CTG-3-2	Gln-CTG-3	GGUUCCAUGGUGUAAUGGUUAGCACUCUGGACUCUGAAUCCAGCGAUCCGAGUUCAAAUCUCGGUGGGACCU	72
tRNA-Gln-CTG-3-3	Gln-CTG-3	GGUUCCAUGGUGUAAUGGUUAGCACUCUGGACUCUGAAUCCAGCGAUCCGAGUUCAAAUCUCGGUGGGACCU	72
tRNA-Gln-TTG-3-1	Gln-TTG-3	GGCCCCAUGGUGUAAUGGUUAGCACUCUGGACUUUGAAUCCAGCGAUCCGAGUUCAAAUCUCGGUGGGACCU	72
tRNA-Gln-TTG-3-2	Gln-TTG-3	GGCCCCAUGGUGUAAUGGUUAGCACUCUGGACUUUGAAUCCAGCGAUCCGAGUUCAAAUCUCGGUGGGACCU	72
tRNA-Glu-CTC-1-1	Glu-CTC-1	UCCCUGGUGGUCUAGUGGUUAGGAUUCGGCGCUCUCACCGCCGCGGCCCGGGUUCGAUUCCCGGUCAGGGAA	72
tRNA-Glu-CTC-1-2	Glu-CTC-1	UCCCUGGUGGUCUAGUGGUUAGGAUUCGGCGCUCUCACCGCCGCGGCCCGGGUUCGAUUCCCGGUCAGGGAA	72
tRNA-Glu-CTC-1-3	Glu-CTC-1	UCCCUGGUGGUCUAGUGGUUAGGAUUCGGCGCUCUCACCGCCGCGGCCCGGGUUCGAUUCCCGGUCAGGGAA	72
tRNA-Glu-CTC-1-4	Glu-CTC-1	UCCCUGGUGGUCUAGUGGUUAGGAUUCGGCGCUCUCACCGCCGCGGCCCGGGUUCGAUUCCCGGUCAGGGAA	72
tRNA-Glu-CTC-1-5	Glu-CTC-1	UCCCUGGUGGUCUAGUGGUUAGGAUUCGGCGCUCUCACCGCCGCGGCCCGGGUUCGAUUCCCGGUCAGGGAA	72
tRNA-Glu-CTC-1-6	Glu-CTC-1	UCCCUGGUGGUCUAGUGGUUAGGAUUCGGCGCUCUCACCGCCGCGGCCCGGGUUCGAUUCCCGGUCAGGGAA	72
tRNA-Glu-CTC-1-7	Glu-CTC-1	UCCCUGGUGGUCUAGUGGUUAGGAUUCGGCGCUCUCACCGCCGCGGCCCGGGUUCGAUUCCCGGUCAGGGAA	72
tRNA-Glu-CTC-1-8	Glu-CTC-1	UCCCUGGUGGUCUAGUGGUUAGGAUUCGGCGCUCUCACCGCCGCGGCCCGGGUUCGAUUCCCGGUCAGGGAA	72
tRNA-Glu-CTC-1-9	Glu-CTC-1	UCCCUGGUGGUCUAGUGGUUAGGAUUCGGCGCUCUCACCGCCGCGGCCCGGGUUCGAUUCCCGGUCAGGGAA	72
tRNA-Glu-TTC-1-1	Glu-TTC-1	UCCCACAUGGUCUAGCGGUUAGGAUUCCUGGUUUUCACCCAGGCGGCCCGGGUUCGACUCCCGGUGUGGGAA	72
tRNA-Glu-TTC-1-2	Glu-TTC-1	UCCCACAUGGUCUAGCGGUUAGGAUUCCUGGUUUUCACCCAGGCGGCCCGGGUUCGACUCCCGGUGUGGGAA	72
tRNA-Glu-TTC-1-3	Glu-TTC-1	UCCCACAUGGUCUAGCGGUUAGGAUUCCUGGUUUUCACCCAGGCGGCCCGGGUUCGACUCCCGGUGUGGGAA	72
tRNA-Glu-TTC-1-4	Glu-TTC-1	UCCCACAUGGUCUAGCGGUUAGGAUUCCUGGUUUUCACCCAGGCGGCCCGGGUUCGACUCCCGGUGUGGGAA	72
tRNA-Glu-TTC-2-1	Glu-TTC-2	UCCCAUAUGGUCUAGCGGUUAGGAUUCCUGGUUUUCACCCAGGCGGCCCGGGUUCGACUCCCGGUAUGGGAA	72
tRNA-Glu-TTC-2-2	Glu-TTC-2	UCCCAUAUGGUCUAGCGGUUAGGAUUCCUGGUUUUCACCCAGGCGGCCCGGGUUCGACUCCCGGUAUGGGAA	72
tRNA-Glu-TTC-3-1	Glu-TTC-3	UCCCUGGUGGUCUAGUGGCUAGGAUUCGGCGCUUUCACCGCCGCGGCCCGGGUUCGAUUCCCGGUCAGGGAA	72
tRNA-Glu-TTC-3-2	Glu-TTC-3	UCCCUGGUGGUCUAGUGGCUAGGAUUCGGCGCUUUCACCGCCGCGGCCCGGGUUCGAUUCCCGGUCAGGGAA	72
tRNA-Gly-CCC-1-1	Gly-CCC-1	GCGCCGCUGGUGUAGUGGUAUCAUGCAAGAUUCCCAUUCUUGCGACCCGGGUUCGAUUCCCGGGCGGCGCA	71
tRNA-Gly-CCC-1-2	Gly-CCC-1	GCGCCGCUGGUGUAGUGGUAUCAUGCAAGAUUCCCAUUCUUGCGACCCGGGUUCGAUUCCCGGGCGGCGCA	71
tRNA-Gly-CCC-2-1	Gly-CCC-2	GCAUUGGUAGUUCAAUGGUAGAAUUCUCGCCUCCCACGCGGGUGACCCGGGUUCGAUUCCCGGCCAAUGCA	71
tRNA-Gly-CCC-2-2	Gly-CCC-2	GCAUUGGUAGUUCAAUGGUAGAAUUCUCGCCUCCCACGCGGGUGACCCGGGUUCGAUUCCCGGCCAAUGCA	71
tRNA-Gly-GCC-1-1	Gly-GCC-1	GCAUGGGUGGUUCAGUGGUAGAAUUCUCGCCUGCCACGCGGGAGGCCCGGGUUCGAUUCCCGGCCCAUGCA	71
tRNA-Gly-GCC-1-2	Gly-GCC-1	GCAUGGGUGGUUCAGUGGUAGAAUUCUCGCCUGCCACGCGGGAGGCCCGGGUUCGAUUCCCGGCCCAUGCA	71
tRNA-Gly-GCC-1-3	Gly-GCC-1	GCAUGGGUGGUUCAGUGGUAGAAUUCUCGCCUGCCACGCGGGAGGCCCGGGUUCGAUUCCCGGCCCAUGCA	71
tRNA-Gly-GCC-2-1	Gly-GCC-2	GCAUUGGUGGUUCAGUGGUAGAAUUCUCGCCUGCCACGCGGGAGGCCCGGGUUCGAUUCCCGGCCAAUGCA	71
tRNA-Gly-GCC-2-2	Gly-GCC-2	GCAUUGGUGGUUCAGUGGUAGAAUUCUCGCCUGCCACGCGGGAGGCCCGGGUUCGAUUCCCGGCCAAUGCA	71
tRNA-Gly-GCC-2-3	Gly-GCC-2	GCAUUGGUGGUUCAGUGGUAGAAUUCUCGCCUGCCACGCGGGAGGCCCGGGUUCGAUUCCCGGCCAAUGCA	71
tRNA-Gly-GCC-2-4	Gly-GCC-2	GCAUUGGUGGUUCAGUGGUAGAAUUCUCGCCUGCCACGCGGGAGGCCCGGGUUCGAUUCCCGGCCAAUGCA	71
tRNA-Gly-GCC-2-5	Gly-GCC-2	GCAUUGGUGGUUCAGUGGUAGAAUUCUCGCCUGCCACGCGGGAGGCCCGGGUUCGAUUCCCGGCCAAUGCA	71
tRNA-Gly-GCC-2-6	Gly-GCC-2	GCAUUGGUGGUUCAGUGGUAGAAUUCUCGCCUGCCACGCGGGAGGCCCGGGUUCGAUUCCCGGCCAAUGCA	71
tRNA-Gly-GCC-2-7	Gly-GCC-2	GCAUUGGUGGUUCAGUGGUAGAAUUCUCGCCUGCCACGCGGGAGGCCCGGGUUCGAUUCCCGGCCAAUGCA	71
tRNA-Gly-GCC-2-8	Gly-GCC-2	GCAUUGGUGGUUCAGUGGUAGAAUUCUCGCCUGCCACGCGGGAGGCCCGGGUUCGAUUCCCGGCCAAUGCA	71
tRNA-Gly-TCC-1-1	Gly-TCC-1	GCGUUGGUGGUAUAGUGGUGAGCAUAGCUGCCUUCCAAGCAGUUGACCCGGGUUCGAUUCCCGGCCAACGCA	72
tRNA-Gly-TCC-1-2	Gly-TCC-1	GCGUUGGUGGUAUAGUGGUGAGCAUAGCUGCCUUCCAAGCAGUUGACCCGGGUUCGAUUCCCGGCCAACGCA	72
tRNA-Gly-TCC-1-3	Gly-TCC-1	GCGUUGGUGGUAUAGUGGUGAGCAUAGCUGCCUUCCAAGCAGUUGACCCGGGUUCGAUUCCCGGCCAACGCA	72
tRNA-Gly-TCC-1-4	Gly-TCC-1	GCGUUGGUGGUAUAGUGGUGAGCAUAGCUGCCUUCCAAGCAGUUGACCCGGGUUCGAUUCCCGGCCAACGCA	72
tRNA-Gly-TCC-1-5	Gly-TCC-1	GCGUUGGUGGUAUAGUGGUGAGCAUAGCUGCCUUCCAAGCAGUUGACCCGGGUUCGAUUCCCGGCCAACGCA	72
tRNA-Gly-TCC-1-6	Gly-TCC-1	GCGUUGGUGGUAUAGUGGUGAGCAUAGCUGCCUUCCAAGCAGUUGACCCGGGUUCGAUUCCCGGCCAACGCA	72
tRNA-Gly-TCC-1-7	Gly-TCC-1	GCGUUGGUGGUAUAGUGGUGAGCAUAGCUGCCUUCCAAGCAGUUGACCCGGGUUCGAUUCCCGGCCAACGCA	72
tRNA-His-GTG-2-1	His-GTG-2	GCCGUGAUCGUAUAGUGGUUAGUACUCUGCGUUGUGGCCGCAGCAACCUCGGUUCGAAUCCGAGUCACGGCA	72
tRNA-His-GTG-2-2	His-GTG-2	GCCGUGAUCGUAUAGUGGUUAGUACUCUGCGUUGUGGCCGCAGCAACCUCGGUUCGAAUCCGAGUCACGGCA	72
tRNA-His-GTG-2-3	His-GTG-2	GCCGUGAUCGUAUAGUGGUUAGUACUCUGCGUUGUGGCCGCAGCAACCUCGGUUCGAAUCCGAGUCACGGCA	72
tRNA-His-GTG-2-4	His-GTG-2	GCCGUGAUCGUAUAGUGGUUAGUACUCUGCGUUGUGGCCGCAGCAACCUCGGUUCGAAUCCGAGUCACGGCA	72
tRNA-His-GTG-2-5	His-GTG-2	GCCGUGAUCGUAUAGUGGUUAGUACUCUGCGUUGUGGCCGCAGCAACCUCGGUUCGAAUCCGAGUCACGGCA	72
tRNA-His-GTG-2-6	His-GTG-2	GCCGUGAUCGUAUAGUGGUUAGUACUCUGCGUUGUGGCCGCAGCAACCUCGGUUCGAAUCCGAGUCACGGCA	72
tRNA-His-GTG-2-7	His-GTG-2	GCCGUGAUCGUAUAGUGGUUAGUACUCUGCGUUGUGGCCGCAGCAACCUCGGUUCGAAUCCGAGUCACGGCA	72
tRNA-His-GTG-2-8	His-GTG-2	GCCGUGAUCGUAUAGUGGUUAGUACUCUGCGUUGUGGCCGCAGCAACCUCGGUUCGAAUCCGAGUCACGGCA	72
tRNA-Ile-AAT-1-1	Ile-AAT-1	GGCCGGUUAGCUCAGUUGGUUAGAGCGUGGUGCUAAUAACGCCAAGGUCGCGGGUUCGAUCCCCGUACGGGCCA	74
tRNA-Ile-AAT-1-2	Ile-AAT-1	GGCCGGUUAGCUCAGUUGGUUAGAGCGUGGUGCUAAUAACGCCAAGGUCGCGGGUUCGAUCCCCGUACGGGCCA	74
tRNA-Ile-AAT-1-3	Ile-AAT-1	GGCCGGUUAGCUCAGUUGGUUAGAGCGUGGUGCUAAUAACGCCAAGGUCGCGGGUUCGAUCCCCGUACGGGCCA	74
tRNA-Ile-AAT-1-4	Ile-AAT-1	GGCCGGUUAGCUCAGUUGGUUAGAGCGUGGUGCUAAUAACGCCAAGGUCGCGGGUUCGAUCCCCGUACGGGCCA	74
tRNA-Ile-AAT-1-5	Ile-AAT-1	GGCCGGUUAGCUCAGUUGGUUAGAGCGUGGUGCUAAUAACGCCAAGGUCGCGGGUUCGAUCCCCGUACGGGCCA	74
tRNA-Ile-AAT-1-6	Ile-AAT-1	GGCCGGUUAGCUCAGUUGGUUAGAGCGUGGUGCUAAUAACGCCAAGGUCGCGGGUUCGAUCCCCGUACGGGCCA	74
tRNA-Ile-AAT-1-7	Ile-AAT-1	GGCCGGUUAGCUCAGUUGGUUAGAGCGUGGUGCUAAUAACGCCAAGGUCGCGGGUUCGAUCCCCGUACGGGCCA	74
tRNA-Ile-AAT-1-8	Ile-AAT-1	GGCCGGUUAGCUCAGUUGGUUAGAGCGUGGUGCUAAUAACGCCAAGGUCGCGGGUUCGAUCCCCGUACGGGCCA	74
tRNA-Ile-TAT-2-1	Ile-TAT-2	GCUCCAGUGGCGCAAUCGGUUAGCGCGCGGUACUUAUAAUGCCGAGGUUGUGAGUUCGAGCCUCACCUGGAGCA	74
tRNA-Ile-TAT-2-2	Ile-TAT-2	GCUCCAGUGGCGCAAUCGGUUAGCGCGCGGUACUUAUAAUGCCGAGGUUGUGAGUUCGAGCCUCACCUGGAGCA	74
tRNA-Ile-TAT-2-3	Ile-TAT-2	GCUCCAGUGGCGCAAUCGGUUAGCGCGCGGUACUUAUAAUGCCGAGGUUGUGAGUUCGAGCCUCACCUGGAGCA	74
tRNA-Leu-AAG-1-1	Leu-AAG-1	GGUAGCGUGGCCGAGCGGUCUAAGGCGCUGGAUUAAGGCUCCAGUCUCUUCGGGGGCGUGGGUUCGAAUCCCACCGCUGCCA	82
tRNA-Leu-AAG-1-2	Leu-AAG-1	GGUAGCGUGGCCGAGCGGUCUAAGGCGCUGGAUUAAGGCUCCAGUCUCUUCGGGGGCGUGGGUUCGAAUCCCACCGCUGCCA	82
tRNA-Leu-AAG-1-3	Leu-AAG-1	GGUAGCGUGGCCGAGCGGUCUAAGGCGCUGGAUUAAGGCUCCAGUCUCUUCGGGGGCGUGGGUUCGAAUCCCACCGCUGCCA	82
tRNA-Leu-CAG-1-1	Leu-CAG-1	GUCAGGAUGGCCGAGCGGUCUAAGGCGCUGCGUUCAGGUCGCAGUCUCCCCUGGAGGCGUGGGUUCGAAUCCCACUCCUGACA	83
tRNA-Leu-CAG-1-2	Leu-CAG-1	GUCAGGAUGGCCGAGCGGUCUAAGGCGCUGCGUUCAGGUCGCAGUCUCCCCUGGAGGCGUGGGUUCGAAUCCCACUCCUGACA	83
tRNA-Leu-CAG-1-3	Leu-CAG-1	GUCAGGAUGGCCGAGCGGUCUAAGGCGCUGCGUUCAGGUCGCAGUCUCCCCUGGAGGCGUGGGUUCGAAUCCCACUCCUGACA	83
tRNA-Leu-CAG-1-4	Leu-CAG-1	GUCAGGAUGGCCGAGCGGUCUAAGGCGCUGCGUUCAGGUCGCAGUCUCCCCUGGAGGCGUGGGUUCGAAUCCCACUCCUGACA	83
tRNA-Leu-CAG-1-5	Leu-CAG-1	GUCAGGAUGGCCGAGCGGUCUAAGGCGCUGCGUUCAGGUCGCAGUCUCCCCUGGAGGCGUGGGUUCGAAUCCCACUCCUGACA	83
tRNA-Leu-CAG-2-1	Leu-CAG-2	GUCAGGAUGGCCGAGCGGUCUAAGGCGCUGCGUUCAGGUCGCAGUCUCCCCUGGAGGCGUGGGUUCGAAUCCCACUUCUGACA	83
tRNA-Leu-CAG-2-2	Leu-CAG-2	GUCAGGAUGGCCGAGCGGUCUAAGGCGCUGCGUUCAGGUCGCAGUCUCCCCUGGAGGCGUGGGUUCGAAUCCCACUUCUGACA	83
tRNA-Leu-CAG-2-3	Leu-CAG-2	GUCAGGAUGGCCGAGCGGUCUAAGGCGCUGCGUUCAGGUCGCAGUCUCCCCUGGAGGCGUGGGUUCGAAUCCCACUUCUGACA	83
tRNA-Lys-CTT-2-1	Lys-CTT-2	GCCCGGCUAGCUCAGUCGGUAGAGCAUGGGACUCUUAAUCCCAGGGUCGUGGGUUCGAGCCCCACGUUGGGCG	73
tRNA-Lys-CTT-2-2	Lys-CTT-2	GCCCGGCUAGCUCAGUCGGUAGAGCAUGGGACUCUUAAUCCCAGGGUCGUGGGUUCGAGCCCCACGUUGGGCG	73
tRNA-Lys-CTT-3-1	Lys-CTT-3	GCCCGGCUAGCUCAGUCGGUAGAGCAUGAGACUCUUAAUCUCAGGGUCGUGGGUUCGAGCCCCACGUUGGGCG	73
tRNA-Lys-CTT-3-2	Lys-CTT-3	GCCCGGCUAGCUCAGUCGGUAGAGCAUGAGACUCUUAAUCUCAGGGUCGUGGGUUCGAGCCCCACGUUGGGCG	73
tRNA-Lys-CTT-3-3	Lys-CTT-3	GCCCGGCUAGCUCAGUCGGUAGAGCAUGAGACUCUUAAUCUCAGGGUCGUGGGUUCGAGCCCCACGUUGGGCG	73
tRNA-Lys-CTT-3-4	Lys-CTT-3	GCCCGGCUAGCUCAGUCGGUAGAGCAUGAGACUCUUAAUCUCAGGGUCGUGGGUUCGAGCCCCACGUUGGGCG	73
tRNA-Lys-CTT-3-5	Lys-CTT-3	GCCCGGCUAGCUCAGUCGGUAGAGCAUGAGACUCUUAAUCUCAGGGUCGUGGGUUCGAGCCCCACGUUGGGCG	73
tRNA-Lys-CTT-3-6	Lys-CTT-3	GCCCGGCUAGCUCAGUCGGUAGAGCAUGAGACUCUUAAUCUCAGGGUCGUGGGUUCGAGCCCCACGUUGGGCG	73
tRNA-Lys-CTT-3-7	Lys-CTT-3	GCCCGGCUAGCUCAGUCGGUAGAGCAUGAGACUCUUAAUCUCAGGGUCGUGGGUUCGAGCCCCACGUUGGGCG	73
tRNA-Lys-TTT-1-1	Lys-TTT-1	GCCCGGAUAGCUCAGUCGGUAGAGCAUCAGACUUUUAAUCUGAGGGUCCAGGGUUCAAGUCCCUGUUCGGGCG	73
tRNA-Lys-TTT-1-2	Lys-TTT-1	GCCCGGAUAGCUCAGUCGGUAGAGCAUCAGACUUUUAAUCUGAGGGUCCAGGGUUCAAGUCCCUGUUCGGGCG	73
tRNA-Lys-TTT-1-3	Lys-TTT-1	GCCCGGAUAGCUCAGUCGGUAGAGCAUCAGACUUUUAAUCUGAGGGUCCAGGGUUCAAGUCCCUGUUCGGGCG	73
tRNA-Lys-TTT-1-4	Lys-TTT-1	GCCCGGAUAGCUCAGUCGGUAGAGCAUCAGACUUUUAAUCUGAGGGUCCAGGGUUCAAGUCCCUGUUCGGGCG	73
tRNA-Lys-TTT-1-5	Lys-TTT-1	GCCCGGAUAGCUCAGUCGGUAGAGCAUCAGACUUUUAAUCUGAGGGUCCAGGGUUCAAGUCCCUGUUCGGGCG	73
tRNA-Lys-TTT-1-6	Lys-TTT-1	GCCCGGAUAGCUCAGUCGGUAGAGCAUCAGACUUUUAAUCUGAGGGUCCAGGGUUCAAGUCCCUGUUCGGGCG	73
tRNA-Lys-TTT-2-1	Lys-TTT-2	GCCUGGAUAGCUCAGUCGGUAGAGCAUCAGACUUUUAAUCUGAGGGUCCAGGGUUCAAGUCCCUGUUCAGGCG	73
tRNA-Lys-TTT-2-2	Lys-TTT-2	GCCUGGAUAGCUCAGUCGGUAGAGCAUCAGACUUUUAAUCUGAGGGUCCAGGGUUCAAGUCCCUGUUCAGGCG	73
tRNA-Lys-TTT-4-1	Lys-TTT-4	GCCCAGCCAGCUCAGUAGGUAGAGUAUGAGACUUUUAAUCUCAGGGUGGUGGGUUCGAGCCCCAUGUUGGGGG	73
tRNA-Lys-TTT-4-2	Lys-TTT-4	GCCCAGCCAGCUCAGUAGGUAGAGUAUGAGACUUUUAAUCUCAGGGUGGUGGGUUCGAGCCCCAUGUUGGGGG	73
tRNA-Lys-TTT-4-3	Lys-TTT-4	GCCCAGCCAGCUCAGUAGGUAGAGUAUGAGACUUUUAAUCUCAGGGUGGUGGGUUCGAGCCCCAUGUUGGGGG	73
tRNA-Met-CAT-1-1	Met-CAT-1	GCCUCGUUAGCGCAGUAGGUAGCGCGUCAGUCUCAUAAUCUGAAGGUCGUGAGUUCGAUCCUCACACGGGGCA	73
tRNA-Met-CAT-1-2	Met-CAT-1	GCCUCGUUAGCGCAGUAGGUAGCGCGUCAGUCUCAUAAUCUGAAGGUCGUGAGUUCGAUCCUCACACGGGGCA	73
tRNA-Met-CAT-2-1	Met-CAT-2	GCCUCCUUAGCGCAGUAGGCAGCGCGUCAGUCUCAUAAUCUGAAGGUCCUGAGUUCGAACCUCAGAGGGGGCA	73
tRNA-Met-CAT-2-2	Met-CAT-2	GCCUCCUUAGCGCAGUAGGCAGCGCGUCAGUCUCAUAAUCUGAAGGUCCUGAGUUCGAACCUCAGAGGGGGCA	73
tRNA-Phe-GAA-1-1	Phe-GAA-1	GCCGAAAUAGCUCAGUUGGGAGAGCGUUAGACUGAAGAUCUAAAGGUCCCUGGUUCGAUCCCGGGUUUCGGCA	73
tRNA-Phe-GAA-1-2	Phe-GAA-1	GCCGAAAUAGCUCAGUUGGGAGAGCGUUAGACUGAAGAUCUAAAGGUCCCUGGUUCGAUCCCGGGUUUCGGCA	73
tRNA-Phe-GAA-1-3	Phe-GAA-1	GCCGAAAUAGCUCAGUUGGGAGAGCGUUAGACUGAAGAUCUAAAGGUCCCUGGUUCGAUCCCGGGUUUCGGCA	73
tRNA-Phe-GAA-1-4	Phe-GAA-1	GCCGAAAUAGCUCAGUUGGGAGAGCGUUAGACUGAAGAUCUAAAGGUCCCUGGUUCGAUCCCGGGUUUCGGCA	73
tRNA-Phe-GAA-1-5	Phe-GAA-1	GCCGAAAUAGCUCAGUUGGGAGAGCGUUAGACUGAAGAUCUAAAGGUCCCUGGUUCGAUCCCGGGUUUCGGCA	73
tRNA-Pro-AGG-1-1	Pro-AGG-1	GGCUCGUUGGUCUAGGGGUAUGAUUCUCGCUUAGGGUGCGAGAGGUCCCGGGUUCAAAUCCCGGACGAGCCC	72
tRNA-Pro-AGG-1-2	Pro-AGG-1	GGCUCGUUGGUCUAGGGGUAUGAUUCUCGCUUAGGGUGCGAGAGGUCCCGGGUUCAAAUCCCGGACGAGCCC	72
tRNA-Pro-AGG-1-3	Pro-AGG-1	GGCUCGUUGGUCUAGGGGUAUGAUUCUCGCUUAGGGUGCGAGAGGUCCCGGGUUCAAAUCCCGGACGAGCCC	72
tRNA-Pro-AGG-1-4	Pro-AGG-1	GGCUCGUUGGUCUAGGGGUAUGAUUCUCGCUUAGGGUGCGAGAGGUCCCGGGUUCAAAUCCCGGACGAGCCC	72
tRNA-Pro-AGG-1-5	Pro-AGG-1	GGCUCGUUGGUCUAGGGGUAUGAUUCUCGCUUAGGGUGCGAGAGGUCCCGGGUUCAAAUCCCGGACGAGCCC	72
tRNA-Pro-AGG-1-6	Pro-AGG-1	GGCUCGUUGGUCUAGGGGUAUGAUUCUCGCUUAGGGUGCGAGAGGUCCCGGGUUCAAAUCCCGGACGAGCCC	72
tRNA-Pro-CGG-1-1	Pro-CGG-1	GGCUCGUUGGUCUAGGGGUAUGAUUCUCGCUUCGGGUGCGAGAGGUCCCGGGUUCAAAUCCCGGACGAGCCC	72
tRNA-Pro-CGG-1-2	Pro-CGG-1	GGCUCGUUGGUCUAGGGGUAUGAUUCUCGCUUCGGGUGCGAGAGGUCCCGGGUUCAAAUCCCGGACGAGCCC	72
tRNA-Pro-CGG-1-3	Pro-CGG-1	GGCUCGUUGGUCUAGGGGUAUGAUUCUCGCUUCGGGUGCGAGAGGUCCCGGGUUCAAAUCCCGGACGAGCCC	72
tRNA-Pro-TGG-2-1	Pro-TGG-2	GGCUCGUUGGUCUAGGGGUAUGAUUCUCGCUUUGGGUGCGAGAGGUCCCGGGUUCAAAUCCCGGACGAGCCC	72
tRNA-Pro-TGG-2-2	Pro-TGG-2	GGCUCGUUGGUCUAGGGGUAUGAUUCUCGCUUUGGGUGCGAGAGGUCCCGGGUUCAAAUCCCGGACGAGCCC	72
tRNA-Pro-TGG-2-3	Pro-TGG-2	GGCUCGUUGGUCUAGGGGUAUGAUUCUCGCUUUGGGUGCGAGAGGUCCCGGGUUCAAAUCCCGGACGAGCCC	72
tRNA-Pro-TGG-2-4	Pro-TGG-2	GGCUCGUUGGUCUAGGGGUAUGAUUCUCGCUUUGGGUGCGAGAGGUCCCGGGUUCAAAUCCCGGACGAGCCC	72
tRNA-Ser-AGA-2-1	Ser-AGA-2	GUAGUCGUGGCCGAGUGGUUAAGGCGAUGGACUAGAAAUCCAUUGGGGUCUCCCCGCGCAGGUUCGAAUCCUGCCGACUACG	82
tRNA-Ser-AGA-2-2	Ser-AGA-2	GUAGUCGUGGCCGAGUGGUUAAGGCGAUGGACUAGAAAUCCAUUGGGGUCUCCCCGCGCAGGUUCGAAUCCUGCCGACUACG	82
tRNA-Ser-AGA-2-3	Ser-AGA-2	GUAGUCGUGGCCGAGUGGUUAAGGCGAUGGACUAGAAAUCCAUUGGGGUCUCCCCGCGCAGGUUCGAAUCCUGCCGACUACG	82
tRNA-Ser-AGA-2-4	Ser-AGA-2	GUAGUCGUGGCCGAGUGGUUAAGGCGAUGGACUAGAAAUCCAUUGGGGUCUCCCCGCGCAGGUUCGAAUCCUGCCGACUACG	82
tRNA-Ser-AGA-2-5	Ser-AGA-2	GUAGUCGUGGCCGAGUGGUUAAGGCGAUGGACUAGAAAUCCAUUGGGGUCUCCCCGCGCAGGUUCGAAUCCUGCCGACUACG	82
tRNA-Ser-AGA-2-6	Ser-AGA-2	GUAGUCGUGGCCGAGUGGUUAAGGCGAUGGACUAGAAAUCCAUUGGGGUCUCCCCGCGCAGGUUCGAAUCCUGCCGACUACG	82
tRNA-Ser-GCT-4-1	Ser-GCT-4	GACGAGGUGGCCGAGUGGUUAAGGCGAUGGACUGCUAAUCCAUUGUGCUCUGCACGCGUGGGUUCGAAUCCCAUCCUCGUCG	82
tRNA-Ser-GCT-4-2	Ser-GCT-4	GACGAGGUGGCCGAGUGGUUAAGGCGAUGGACUGCUAAUCCAUUGUGCUCUGCACGCGUGGGUUCGAAUCCCAUCCUCGUCG	82
tRNA-Ser-GCT-4-3	Ser-GCT-4	GACGAGGUGGCCGAGUGGUUAAGGCGAUGGACUGCUAAUCCAUUGUGCUCUGCACGCGUGGGUUCGAAUCCCAUCCUCGUCG	82
tRNA-Ser-TGA-2-1	Ser-TGA-2	GUAGUCGUGGCCGAGUGGUUAAGGCGAUGGACUUGAAAUCCAUUGGGGUUUCCCCGCGCAGGUUCGAAUCCUGCCGACUACG	82
tRNA-Ser-TGA-2-2	Ser-TGA-2	GUAGUCGUGGCCGAGUGGUUAAGGCGAUGGACUUGAAAUCCAUUGGGGUUUCCCCGCGCAGGUUCGAAUCCUGCCGACUACG	82
tRNA-Thr-AGT-1-1	Thr-AGT-1	GGCGCCGUGGCUUAGUUGGUUAAAGCGCCUGUCUAGUAAACAGGAGAUCCUGGGUUCGAAUCCCAGCGGUGCCU	74
tRNA-Thr-AGT-1-2	Thr-AGT-1	GGCGCCGUGGCUUAGUUGGUUAAAGCGCCUGUCUAGUAAACAGGAGAUCCUGGGUUCGAAUCCCAGCGGUGCCU	74
tRNA-Thr-AGT-1-3	Thr-AGT-1	GGCGCCGUGGCUUAGUUGGUUAAAGCGCCUGUCUAGUAAACAGGAGAUCCUGGGUUCGAAUCCCAGCGGUGCCU	74
tRNA-Thr-TGT-3-1	Thr-TGT-3	GGCUCCAUAGCUCAGGGGUUAGAGCACUGGUCUUGUAAACCAGGGGUCGCGAGUUCAAAUCUCGCUGGGGCCU	73
tRNA-Thr-TGT-3-2	Thr-TGT-3	GGCUCCAUAGCUCAGGGGUUAGAGCACUGGUCUUGUAAACCAGGGGUCGCGAGUUCAAAUCUCGCUGGGGCCU	73
tRNA-Trp-CCA-3-1	Trp-CCA-3	GGCCUCGUGGCGCAACGGUAGCGCGUCUGACUCCAGAUCAGAAGGUUGCGUGUUCAAAUCACGUCGGGGUCA	72
tRNA-Trp-CCA-3-2	Trp-CCA-3	GGCCUCGUGGCGCAACGGUAGCGCGUCUGACUCCAGAUCAGAAGGUUGCGUGUUCAAAUCACGUCGGGGUCA	72
tRNA-Trp-CCA-4-1	Trp-CCA-4	GACCUCGUGGCGCAACGGUAGCGCGUCUGACUCCAGAUCAGAAGGUUGCGUGUUCAAAUCACGUCGGGGUCA	72
tRNA-Trp-CCA-4-2	Trp-CCA-4	GACCUCGUGGCGCAACGGUAGCGCGUCUGACUCCAGAUCAGAAGGUUGCGUGUUCAAAUCACGUCGGGGUCA	72
tRNA-Tyr-GTA-1-1	Tyr-GTA-1	CCUUCGAUAGCUCAGUUGGUAGAGCGGAGGACUGUAGAUCCUUAGGUCGCUGGUUCGAAUCCGGCUCGAAGGA	73
tRNA-Tyr-GTA-1-2	Tyr-GTA-1	CCUUCGAUAGCUCAGUUGGUAGAGCGGAGGACUGUAGAUCCUUAGGUCGCUGGUUCGAAUCCGGCUCGAAGGA	73
tRNA-Tyr-GTA-1-3	Tyr-GTA-1	CCUUCGAUAGCUCAGUUGGUAGAGCGGAGGACUGUAGAUCCUUAGGUCGCUGGUUCGAAUCCGGCUCGAAGGA	73
tRNA-Tyr-GTA-1-4	Tyr-GTA-1	CCUUCGAUAGCUCAGUUGGUAGAGCGGAGGACUGUAGAUCCUUAGGUCGCUGGUUCGAAUCCGGCUCGAAGGA	73
tRNA-Tyr-GTA-1-5	Tyr-GTA-1	CCUUCGAUAGCUCAGUUGGUAGAGCGGAGGACUGUAGAUCCUUAGGUCGCUGGUUCGAAUCCGGCUCGAAGGA	73
tRNA-Tyr-GTA-3-1	Tyr-GTA-3	CCUUCGAUAGCUCAGCUGGUAGAGCGGAGGACUGUAGAUCCUUAGGUCGCUGGUUCGAUUCCGGCUCGAAGGA	73
tRNA-Tyr-GTA-3-2	Tyr-GTA-3	CCUUCGAUAGCUCAGCUGGUAGAGCGGAGGACUGUAGAUCCUUAGGUCGCUGGUUCGAUUCCGGCUCGAAGGA	73
tRNA-Val-AAC-1-1	Val-AAC-1	GUUUCCGUAGUGUAGUGGUUAUCACGUUCGCCUAACACGCGAAAGGUCCCCGGUUCGAAACCGGGCGGAAACA	73
tRNA-Val-AAC-1-2	Val-AAC-1	GUUUCCGUAGUGUAGUGGUUAUCACGUUCGCCUAACACGCGAAAGGUCCCCGGUUCGAAACCGGGCGGAAACA	73
tRNA-Val-AAC-2-1	Val-AAC-2	GUUUCCGUAGUGUAGUGGUCAUCACGCUCGCCUAACACGCGAGAGGUCCCCGGUUCGAAACCGGGCGGAAACA	73
tRNA-Val-AAC-2-2	Val-AAC-2	GUUUCCGUAGUGUAGUGGUCAUCACGCUCGCCUAACACGCGAGAGGUCCCCGGUUCGAAACCGGGCGGAAACA	73
tRNA-Val-CAC-2-1	Val-CAC-2	GUUUCCGUAGUGUAGUGGUUAUCACGUUCGCCUCACACGCGAAAGGUCCCCGGUUCGAAACCGGGCGGAAACA	73
tRNA-Val-CAC-2-2	Val-CAC-2	GUUUCCGUAGUGUAGUGGUUAUCACGUUCGCCUCACACGCGAAAGGUCCCCGGUUCGAAACCGGGCGGAAACA	73
tRNA-Val-CAC-2-3	Val-CAC-2	GUUUCCGUAGUGUAGUGGUUAUCACGUUCGCCUCACACGCGAAAGGUCCCCGGUUCGAAACCGGGCGGAAACA	73
tRNA-Val-CAC-2-4	Val-CAC-2	GUUUCCGUAGUGUAGUGGUUAUCACGUUCGCCUCACACGCGAAAGGUCCCCGGUUCGAAACCGGGCGGAAACA	73
tRNA-Val-CAC-2-5	Val-CAC-2	GUUUCCGUAGUGUAGUGGUUAUCACGUUCGCCUCACACGCGAAAGGUCCCCGGUUCGAAACCGGGCGGAAACA	73
tRNA-Val-TAC-1-1	Val-TAC-1	GGUUCCAUAGUGUAGCGGUUAUCACGUCUGCUUUACACGCAGAAGGUCCUGGGUUCGAGCCCCAGUGGAACCA	73
tRNA-Val-TAC-1-2	Val-TAC-1	GGUUCCAUAGUGUAGCGGUUAUCACGUCUGCUUUACACGCAGAAGGUCCUGGGUUCGAGCCCCAGUGGAACCA	73
tRNA-Val-TAC-1-3	Val-TAC-1	GGUUCCAUAGUGUAGCGGUUAUCACGUCUGCUUUACACGCAGAAGGUCCUGGGUUCGAGCCCCAGUGGAACCA	73
tRNA-iMet-CAT-1-1	iMet-CAT-1	AGCAGAGUGGCGCAGCGGAAGCGUGCUGGGCCCAUAACCCAGAGGUCGAUGGAUCGAAACCAUCCUCUGCUA	72
tRNA-iMet-CAT-1-2	iMet-CAT-1	AGCAGAGUGGCGCAGCGGAAGCGUGCUGGGCCCAUAACCCAGAGGUCGAUGGAUCGAAACCAUCCUCUGCUA	72
tRNA-iMet-CAT-1-3	iMet-CAT-1	AGCAGAGUGGCGCAGCGGAAGCGUGCUGGGCCCAUAACCCAGAGGUCGAUGGAUCGAAACCAUCCUCUGCUA	72
tRNA-iMet-CAT-1-4	iMet-CAT-1	AGCAGAGUGGCGCAGCGGAAGCGUGCUGGGCCCAUAACCCAGAGGUCGAUGGAUCGAAACCAUCCUCUGCUA	72
tRNA-iMet-CAT-1-5	iMet-CAT-1	AGCAGAGUGGCGCAGCGGAAGCGUGCUGGGCCCAUAACCCAGAGGUCGAUGGAUCGAAACCAUCCUCUGCUA	72
tRNA-iMet-CAT-1-6	iMet-CAT-1	AGCAGAGUGGCGCAGCGGAAGCGUGCUGGGCCCAUAACCCAGAGGUCGAUGGAUCGAAACCAUCCUCUGCUA	72
tRNA-iMet-CAT-1-7	iMet-CAT-1	AGCAGAGUGGCGCAGCGGAAGCGUGCUGGGCCCAUAACCCAGAGGUCGAUGGAUCGAAACCAUCCUCUGCUA	72
