"seq"	"len"	"iso"
"Homo_sapiens_tRNA-Ala-AGC-10-1"	"GGGGAATTAGCTCAAGTGGTAGAGCGCTTGCTTAGCACGCAAGAGGTAGTGGGATCGATGCCCACATTCTCCA"	73	"tRNA-Ala-AGC-10"
"Homo_sapiens_tRNA-Ala-AGC-10-2"	"GGGGAATTAGCTCAAGTGGTAGAGCGCTTGCTTAGCACGCAAGAGGTAGTGGGATCGATGCCCACATTCTCCA"	73	"tRNA-Ala-AGC-10"
"Homo_sapiens_tRNA-Ala-AGC-12-1"	"GGGGAATTAGCTCAAGTGGTAGAGCGCTTGCTTAGCATGCAAGAGGTAGTGGGATCGATGCCCACATTCTCCA"	73	"tRNA-Ala-AGC-12"
"Homo_sapiens_tRNA-Ala-AGC-12-2"	"GGGGAATTAGCTCAAGTGGTAGAGCGCTTGCTTAGCATGCAAGAGGTAGTGGGATCGATGCCCACATTCTCCA"	73	"tRNA-Ala-AGC-12"
"Homo_sapiens_tRNA-Ala-AGC-12-3"	"GGGGAATTAGCTCAAGTGGTAGAGCGCTTGCTTAGCATGCAAGAGGTAGTGGGATCGATGCCCACATTCTCCA"	73	"tRNA-Ala-AGC-12"
"Homo_sapiens_tRNA-Ala-AGC-13-1"	"GGGGAATTAGCTCAAGCGGTAGAGCGCTTGCTTAGCATGCAAGAGGTAGTGGGATCGATGCCCACATTCTCCA"	73	"tRNA-Ala-AGC-13"
"Homo_sapiens_tRNA-Ala-AGC-13-2"	"GGGGAATTAGCTCAAGCGGTAGAGCGCTTGCTTAGCATGCAAGAGGTAGTGGGATCGATGCCCACATTCTCCA"	73	"tRNA-Ala-AGC-13"
"Homo_sapiens_tRNA-Ala-AGC-13-3"	"GGGGAATTAGCTCAAGCGGTAGAGCGCTTGCTTAGCATGCAAGAGGTAGTGGGATCGATGCCCACATTCTCCA"	73	"tRNA-Ala-AGC-13"
"Homo_sapiens_tRNA-Ala-AGC-14-1"	"GGGGAATTAGCTCAAGTGGTAGAGCGCTTGCTTAGCATGCAAGAGGTAGTGGGATCAATGCCCACATTCTCCA"	73	"tRNA-Ala-AGC-14"
"Homo_sapiens_tRNA-Ala-AGC-14-2"	"GGGGAATTAGCTCAAGTGGTAGAGCGCTTGCTTAGCATGCAAGAGGTAGTGGGATCAATGCCCACATTCTCCA"	73	"tRNA-Ala-AGC-14"
"Homo_sapiens_tRNA-Ala-AGC-2-1"	"GGGGGTGTAGCTCAGTGGTAGAGCGCGTGCTTAGCATGCACGAGGCCCCGGGTTCAATCCCCGGCACCTCCA"	72	"tRNA-Ala-AGC-2"
"Homo_sapiens_tRNA-Ala-AGC-2-2"	"GGGGGTGTAGCTCAGTGGTAGAGCGCGTGCTTAGCATGCACGAGGCCCCGGGTTCAATCCCCGGCACCTCCA"	72	"tRNA-Ala-AGC-2"
"Homo_sapiens_tRNA-Ala-AGC-7-1"	"GGGGGTGTAGCTCAGTGGTAGAGCGCGTGCTTAGCATGCACGAGGCCCCGGGTTCAATCCCCGGCACCTCCA"	72	"tRNA-Ala-AGC-7"
"Homo_sapiens_tRNA-Ala-AGC-8-1"	"GGGGGATTAGCTCAAATGGTAGAGCGCTCGCTTAGCATGCGAGAGGTAGCGGGATCGATGCCCGCATCCTCCA"	73	"tRNA-Ala-AGC-8"
"Homo_sapiens_tRNA-Ala-AGC-8-2"	"GGGGGATTAGCTCAAATGGTAGAGCGCTCGCTTAGCATGCGAGAGGTAGCGGGATCGATGCCCGCATCCTCCA"	73	"tRNA-Ala-AGC-8"
"Homo_sapiens_tRNA-Ala-AGC-9-1"	"GGGGAATTAGCTCAGGCGGTAGAGCGCTCGCTTAGCATGCGAGAGGTAGCGGGATCGACGCCCGCATTCTCCA"	73	"tRNA-Ala-AGC-9"
"Homo_sapiens_tRNA-Ala-AGC-9-2"	"GGGGAATTAGCTCAGGCGGTAGAGCGCTCGCTTAGCATGCGAGAGGTAGCGGGATCGACGCCCGCATTCTCCA"	73	"tRNA-Ala-AGC-9"
"Homo_sapiens_tRNA-Ala-TGC-3-1"	"GGGGATGTAGCTCAGTGGTAGAGCGCATGCTTTGCATGTATGAGGCCCCGGGTTCGATCCCCGGCATCTCCA"	72	"tRNA-Ala-TGC-3"
"Homo_sapiens_tRNA-Ala-TGC-3-2"	"GGGGATGTAGCTCAGTGGTAGAGCGCATGCTTTGCATGTATGAGGCCCCGGGTTCGATCCCCGGCATCTCCA"	72	"tRNA-Ala-TGC-3"
"Homo_sapiens_tRNA-Arg-ACG-1-1"	"GGGCCAGTGGCGCAATGGATAACGCGTCTGACTACGGATCAGAAGATTCCAGGTTCGACTCCTGGCTGGCTCG"	73	"tRNA-Arg-ACG-1"
"Homo_sapiens_tRNA-Arg-ACG-1-2"	"GGGCCAGTGGCGCAATGGATAACGCGTCTGACTACGGATCAGAAGATTCCAGGTTCGACTCCTGGCTGGCTCG"	73	"tRNA-Arg-ACG-1"
"Homo_sapiens_tRNA-Arg-ACG-1-3"	"GGGCCAGTGGCGCAATGGATAACGCGTCTGACTACGGATCAGAAGATTCCAGGTTCGACTCCTGGCTGGCTCG"	73	"tRNA-Arg-ACG-1"
"Homo_sapiens_tRNA-Arg-ACG-2-1"	"GGGCCAGTGGCGCAATGGATAACGCGTCTGACTACGGATCAGAAGATTCTAGGTTCGACTCCTGGCTGGCTCG"	73	"tRNA-Arg-ACG-2"
"Homo_sapiens_tRNA-Arg-ACG-2-2"	"GGGCCAGTGGCGCAATGGATAACGCGTCTGACTACGGATCAGAAGATTCTAGGTTCGACTCCTGGCTGGCTCG"	73	"tRNA-Arg-ACG-2"
"Homo_sapiens_tRNA-Arg-ACG-2-3"	"GGGCCAGTGGCGCAATGGATAACGCGTCTGACTACGGATCAGAAGATTCTAGGTTCGACTCCTGGCTGGCTCG"	73	"tRNA-Arg-ACG-2"
"Homo_sapiens_tRNA-Arg-ACG-2-4"	"GGGCCAGTGGCGCAATGGATAACGCGTCTGACTACGGATCAGAAGATTCTAGGTTCGACTCCTGGCTGGCTCG"	73	"tRNA-Arg-ACG-2"
"Homo_sapiens_tRNA-Arg-CCG-1-1"	"GGCCGCGTGGCCTAATGGATAAGGCGTCTGATTCCGGATCAGAAGATTGAGGGTTCGAGTCCCTTCGTGGTCG"	73	"tRNA-Arg-CCG-1"
"Homo_sapiens_tRNA-Arg-CCG-1-2"	"GGCCGCGTGGCCTAATGGATAAGGCGTCTGATTCCGGATCAGAAGATTGAGGGTTCGAGTCCCTTCGTGGTCG"	73	"tRNA-Arg-CCG-1"
"Homo_sapiens_tRNA-Arg-CCG-1-3"	"GGCCGCGTGGCCTAATGGATAAGGCGTCTGATTCCGGATCAGAAGATTGAGGGTTCGAGTCCCTTCGTGGTCG"	73	"tRNA-Arg-CCG-1"
"Homo_sapiens_tRNA-Asn-GTT-11-1"	"GTCTCTGTGGTGCAATCGGTTAGCGCGTTCCGCTGTTAACCGAAAGCTTGGTGGTTCGAGCCCACCCAGGGATG"	74	"tRNA-Asn-GTT-11"
"Homo_sapiens_tRNA-Asn-GTT-11-2"	"GTCTCTGTGGTGCAATCGGTTAGCGCGTTCCGCTGTTAACCGAAAGCTTGGTGGTTCGAGCCCACCCAGGGATG"	74	"tRNA-Asn-GTT-11"
"Homo_sapiens_tRNA-Asn-GTT-2-1"	"GTCTCTGTGGCGCAATCGGTTAGCGCGTTCGGCTGTTAACCGAAAGGTTGGTGGTTCGAGCCCACCCAGGGACG"	74	"tRNA-Asn-GTT-2"
"Homo_sapiens_tRNA-Asn-GTT-2-2"	"GTCTCTGTGGCGCAATCGGTTAGCGCGTTCGGCTGTTAACCGAAAGGTTGGTGGTTCGAGCCCACCCAGGGACG"	74	"tRNA-Asn-GTT-2"
"Homo_sapiens_tRNA-Asn-GTT-2-3"	"GTCTCTGTGGCGCAATCGGTTAGCGCGTTCGGCTGTTAACCGAAAGGTTGGTGGTTCGAGCCCACCCAGGGACG"	74	"tRNA-Asn-GTT-2"
"Homo_sapiens_tRNA-Asn-GTT-2-4"	"GTCTCTGTGGCGCAATCGGTTAGCGCGTTCGGCTGTTAACCGAAAGGTTGGTGGTTCGAGCCCACCCAGGGACG"	74	"tRNA-Asn-GTT-2"
"Homo_sapiens_tRNA-Asn-GTT-2-5"	"GTCTCTGTGGCGCAATCGGTTAGCGCGTTCGGCTGTTAACCGAAAGGTTGGTGGTTCGAGCCCACCCAGGGACG"	74	"tRNA-Asn-GTT-2"
"Homo_sapiens_tRNA-Asn-GTT-2-6"	"GTCTCTGTGGCGCAATCGGTTAGCGCGTTCGGCTGTTAACCGAAAGGTTGGTGGTTCGAGCCCACCCAGGGACG"	74	"tRNA-Asn-GTT-2"
"Homo_sapiens_tRNA-Asn-GTT-2-7"	"GTCTCTGTGGCGCAATCGGTTAGCGCGTTCGGCTGTTAACCGAAAGGTTGGTGGTTCGAGCCCACCCAGGGACG"	74	"tRNA-Asn-GTT-2"
"Homo_sapiens_tRNA-Asn-GTT-2-8"	"GTCTCTGTGGCGCAATCGGTTAGCGCGTTCGGCTGTTAACCGAAAGGTTGGTGGTTCGAGCCCACCCAGGGACG"	74	"tRNA-Asn-GTT-2"
"Homo_sapiens_tRNA-Asp-GTC-2-1"	"TCCTCGTTAGTATAGTGGTGAGTATCCCCGCCTGTCACGCGGGAGACCGGGGTTCGATTCCCCGACGGGGAG"	72	"tRNA-Asp-GTC-2"
"Homo_sapiens_tRNA-Asp-GTC-2-10"	"TCCTCGTTAGTATAGTGGTGAGTATCCCCGCCTGTCACGCGGGAGACCGGGGTTCGATTCCCCGACGGGGAG"	72	"tRNA-Asp-GTC-2"
"Homo_sapiens_tRNA-Asp-GTC-2-11"	"TCCTCGTTAGTATAGTGGTGAGTATCCCCGCCTGTCACGCGGGAGACCGGGGTTCGATTCCCCGACGGGGAG"	72	"tRNA-Asp-GTC-2"
"Homo_sapiens_tRNA-Asp-GTC-2-2"	"TCCTCGTTAGTATAGTGGTGAGTATCCCCGCCTGTCACGCGGGAGACCGGGGTTCGATTCCCCGACGGGGAG"	72	"tRNA-Asp-GTC-2"
"Homo_sapiens_tRNA-Asp-GTC-2-3"	"TCCTCGTTAGTATAGTGGTGAGTATCCCCGCCTGTCACGCGGGAGACCGGGGTTCGATTCCCCGACGGGGAG"	72	"tRNA-Asp-GTC-2"
"Homo_sapiens_tRNA-Asp-GTC-2-4"	"TCCTCGTTAGTATAGTGGTGAGTATCCCCGCCTGTCACGCGGGAGACCGGGGTTCGATTCCCCGACGGGGAG"	72	"tRNA-Asp-GTC-2"
"Homo_sapiens_tRNA-Asp-GTC-2-5"	"TCCTCGTTAGTATAGTGGTGAGTATCCCCGCCTGTCACGCGGGAGACCGGGGTTCGATTCCCCGACGGGGAG"	72	"tRNA-Asp-GTC-2"
"Homo_sapiens_tRNA-Asp-GTC-2-6"	"TCCTCGTTAGTATAGTGGTGAGTATCCCCGCCTGTCACGCGGGAGACCGGGGTTCGATTCCCCGACGGGGAG"	72	"tRNA-Asp-GTC-2"
"Homo_sapiens_tRNA-Asp-GTC-2-7"	"TCCTCGTTAGTATAGTGGTGAGTATCCCCGCCTGTCACGCGGGAGACCGGGGTTCGATTCCCCGACGGGGAG"	72	"tRNA-Asp-GTC-2"
"Homo_sapiens_tRNA-Asp-GTC-2-8"	"TCCTCGTTAGTATAGTGGTGAGTATCCCCGCCTGTCACGCGGGAGACCGGGGTTCGATTCCCCGACGGGGAG"	72	"tRNA-Asp-GTC-2"
"Homo_sapiens_tRNA-Asp-GTC-2-9"	"TCCTCGTTAGTATAGTGGTGAGTATCCCCGCCTGTCACGCGGGAGACCGGGGTTCGATTCCCCGACGGGGAG"	72	"tRNA-Asp-GTC-2"
"Homo_sapiens_tRNA-Cys-GCA-2-1"	"GGGGGTATAGCTCAGTGGTAGAGCATTTGACTGCAGATCAAGAGGTCCCCGGTTCAAATCCGGGTGCCCCCT"	72	"tRNA-Cys-GCA-2"
"Homo_sapiens_tRNA-Cys-GCA-2-2"	"GGGGGTATAGCTCAGTGGTAGAGCATTTGACTGCAGATCAAGAGGTCCCCGGTTCAAATCCGGGTGCCCCCT"	72	"tRNA-Cys-GCA-2"
"Homo_sapiens_tRNA-Cys-GCA-2-3"	"GGGGGTATAGCTCAGTGGTAGAGCATTTGACTGCAGATCAAGAGGTCCCCGGTTCAAATCCGGGTGCCCCCT"	72	"tRNA-Cys-GCA-2"
"Homo_sapiens_tRNA-Cys-GCA-2-4"	"GGGGGTATAGCTCAGTGGTAGAGCATTTGACTGCAGATCAAGAGGTCCCCGGTTCAAATCCGGGTGCCCCCT"	72	"tRNA-Cys-GCA-2"
"Homo_sapiens_tRNA-Cys-GCA-9-1"	"GGGGGTATAGCTCAGGGGTAGAGCATTTGACTGCAGATCAAGAGGTCCCTGGTTCAAATCCAGGTGCCCCCT"	72	"tRNA-Cys-GCA-9"
"Homo_sapiens_tRNA-Cys-GCA-9-2"	"GGGGGTATAGCTCAGGGGTAGAGCATTTGACTGCAGATCAAGAGGTCCCTGGTTCAAATCCAGGTGCCCCCT"	72	"tRNA-Cys-GCA-9"
"Homo_sapiens_tRNA-Cys-GCA-9-3"	"GGGGGTATAGCTCAGGGGTAGAGCATTTGACTGCAGATCAAGAGGTCCCTGGTTCAAATCCAGGTGCCCCCT"	72	"tRNA-Cys-GCA-9"
"Homo_sapiens_tRNA-Cys-GCA-9-4"	"GGGGGTATAGCTCAGGGGTAGAGCATTTGACTGCAGATCAAGAGGTCCCTGGTTCAAATCCAGGTGCCCCCT"	72	"tRNA-Cys-GCA-9"
"Homo_sapiens_tRNA-Gln-CTG-1-1"	"GGTTCCATGGTGTAATGGTTAGCACTCTGGACTCTGAATCCAGCGATCCGAGTTCAAATCTCGGTGGAACCT"	72	"tRNA-Gln-CTG-1"
"Homo_sapiens_tRNA-Gln-CTG-1-2"	"GGTTCCATGGTGTAATGGTTAGCACTCTGGACTCTGAATCCAGCGATCCGAGTTCAAATCTCGGTGGAACCT"	72	"tRNA-Gln-CTG-1"
"Homo_sapiens_tRNA-Gln-CTG-1-3"	"GGTTCCATGGTGTAATGGTTAGCACTCTGGACTCTGAATCCAGCGATCCGAGTTCAAATCTCGGTGGAACCT"	72	"tRNA-Gln-CTG-1"
"Homo_sapiens_tRNA-Gln-CTG-1-4"	"GGTTCCATGGTGTAATGGTTAGCACTCTGGACTCTGAATCCAGCGATCCGAGTTCAAATCTCGGTGGAACCT"	72	"tRNA-Gln-CTG-1"
"Homo_sapiens_tRNA-Gln-CTG-1-5"	"GGTTCCATGGTGTAATGGTTAGCACTCTGGACTCTGAATCCAGCGATCCGAGTTCAAATCTCGGTGGAACCT"	72	"tRNA-Gln-CTG-1"
"Homo_sapiens_tRNA-Gln-CTG-3-1"	"GGTTCCATGGTGTAATGGTGAGCACTCTGGACTCTGAATCCAGCGATCCGAGTTCGAGTCTCGGTGGAACCT"	72	"tRNA-Gln-CTG-3"
"Homo_sapiens_tRNA-Gln-CTG-3-2"	"GGTTCCATGGTGTAATGGTGAGCACTCTGGACTCTGAATCCAGCGATCCGAGTTCGAGTCTCGGTGGAACCT"	72	"tRNA-Gln-CTG-3"
"Homo_sapiens_tRNA-Gln-CTG-4-1"	"GGTTCCATGGTGTAATGGTAAGCACTCTGGACTCTGAATCCAGCGATCCGAGTTCGAGTCTCGGTGGAACCT"	72	"tRNA-Gln-CTG-4"
"Homo_sapiens_tRNA-Gln-CTG-4-2"	"GGTTCCATGGTGTAATGGTAAGCACTCTGGACTCTGAATCCAGCGATCCGAGTTCGAGTCTCGGTGGAACCT"	72	"tRNA-Gln-CTG-4"
"Homo_sapiens_tRNA-Gln-TTG-3-1"	"GGCCCCATGGTGTAATGGTTAGCACTCTGGACTTTGAATCCAGCGATCCGAGTTCAAATCTCGGTGGGACCT"	72	"tRNA-Gln-TTG-3"
"Homo_sapiens_tRNA-Gln-TTG-3-2"	"GGCCCCATGGTGTAATGGTTAGCACTCTGGACTTTGAATCCAGCGATCCGAGTTCAAATCTCGGTGGGACCT"	72	"tRNA-Gln-TTG-3"
"Homo_sapiens_tRNA-Gln-TTG-3-3"	"GGCCCCATGGTGTAATGGTTAGCACTCTGGACTTTGAATCCAGCGATCCGAGTTCAAATCTCGGTGGGACCT"	72	"tRNA-Gln-TTG-3"
"Homo_sapiens_tRNA-Glu-CTC-1-1"	"TCCCTGGTGGTCTAGTGGTTAGGATTCGGCGCTCTCACCGCCGCGGCCCGGGTTCGATTCCCGGTCAGGGAA"	72	"tRNA-Glu-CTC-1"
"Homo_sapiens_tRNA-Glu-CTC-1-2"	"TCCCTGGTGGTCTAGTGGTTAGGATTCGGCGCTCTCACCGCCGCGGCCCGGGTTCGATTCCCGGTCAGGGAA"	72	"tRNA-Glu-CTC-1"
"Homo_sapiens_tRNA-Glu-CTC-1-3"	"TCCCTGGTGGTCTAGTGGTTAGGATTCGGCGCTCTCACCGCCGCGGCCCGGGTTCGATTCCCGGTCAGGGAA"	72	"tRNA-Glu-CTC-1"
"Homo_sapiens_tRNA-Glu-CTC-1-4"	"TCCCTGGTGGTCTAGTGGTTAGGATTCGGCGCTCTCACCGCCGCGGCCCGGGTTCGATTCCCGGTCAGGGAA"	72	"tRNA-Glu-CTC-1"
"Homo_sapiens_tRNA-Glu-CTC-1-5"	"TCCCTGGTGGTCTAGTGGTTAGGATTCGGCGCTCTCACCGCCGCGGCCCGGGTTCGATTCCCGGTCAGGGAA"	72	"tRNA-Glu-CTC-1"
"Homo_sapiens_tRNA-Glu-CTC-1-6"	"TCCCTGGTGGTCTAGTGGTTAGGATTCGGCGCTCTCACCGCCGCGGCCCGGGTTCGATTCCCGGTCAGGGAA"	72	"tRNA-Glu-CTC-1"
"Homo_sapiens_tRNA-Glu-CTC-1-7"	"TCCCTGGTGGTCTAGTGGTTAGGATTCGGCGCTCTCACCGCCGCGGCCCGGGTTCGATTCCCGGTCAGGGAA"	72	"tRNA-Glu-CTC-1"
"Homo_sapiens_tRNA-Glu-TTC-1-1"	"TCCCATATGGTCTAGCGGTTAGGATTCCTGGTTTTCACCCAGGTGGCCCGGGTTCGACTCCCGGTATGGGAA"	72	"tRNA-Glu-TTC-1"
"Homo_sapiens_tRNA-Glu-TTC-1-2"	"TCCCATATGGTCTAGCGGTTAGGATTCCTGGTTTTCACCCAGGTGGCCCGGGTTCGACTCCCGGTATGGGAA"	72	"tRNA-Glu-TTC-1"
"Homo_sapiens_tRNA-Glu-TTC-2-1"	"TCCCACATGGTCTAGCGGTTAGGATTCCTGGTTTTCACCCAGGCGGCCCGGGTTCGACTCCCGGTGTGGGAA"	72	"tRNA-Glu-TTC-2"
"Homo_sapiens_tRNA-Glu-TTC-2-2"	"TCCCACATGGTCTAGCGGTTAGGATTCCTGGTTTTCACCCAGGCGGCCCGGGTTCGACTCCCGGTGTGGGAA"	72	"tRNA-Glu-TTC-2"
"Homo_sapiens_tRNA-Glu-TTC-4-1"	"TCCCTGGTGGTCTAGTGGCTAGGATTCGGCGCTTTCACCGCCGCGGCCCGGGTTCGATTCCCGGTCAGGGAA"	72	"tRNA-Glu-TTC-4"
"Homo_sapiens_tRNA-Glu-TTC-4-2"	"TCCCTGGTGGTCTAGTGGCTAGGATTCGGCGCTTTCACCGCCGCGGCCCGGGTTCGATTCCCGGTCAGGGAA"	72	"tRNA-Glu-TTC-4"
"Homo_sapiens_tRNA-Gly-CCC-1-1"	"GCATTGGTGGTTCAGTGGTAGAATTCTCGCCTCCCACGCGGGAGACCCGGGTTCAATTCCCGGCCAATGCA"	71	"tRNA-Gly-CCC-1"
"Homo_sapiens_tRNA-Gly-CCC-1-2"	"GCATTGGTGGTTCAGTGGTAGAATTCTCGCCTCCCACGCGGGAGACCCGGGTTCAATTCCCGGCCAATGCA"	71	"tRNA-Gly-CCC-1"
"Homo_sapiens_tRNA-Gly-CCC-2-1"	"GCGCCGCTGGTGTAGTGGTATCATGCAAGATTCCCATTCTTGCGACCCGGGTTCGATTCCCGGGCGGCGCA"	71	"tRNA-Gly-CCC-2"
"Homo_sapiens_tRNA-Gly-CCC-2-2"	"GCGCCGCTGGTGTAGTGGTATCATGCAAGATTCCCATTCTTGCGACCCGGGTTCGATTCCCGGGCGGCGCA"	71	"tRNA-Gly-CCC-2"
"Homo_sapiens_tRNA-Gly-GCC-1-1"	"GCATGGGTGGTTCAGTGGTAGAATTCTCGCCTGCCACGCGGGAGGCCCGGGTTCGATTCCCGGCCCATGCA"	71	"tRNA-Gly-GCC-1"
"Homo_sapiens_tRNA-Gly-GCC-1-2"	"GCATGGGTGGTTCAGTGGTAGAATTCTCGCCTGCCACGCGGGAGGCCCGGGTTCGATTCCCGGCCCATGCA"	71	"tRNA-Gly-GCC-1"
"Homo_sapiens_tRNA-Gly-GCC-1-3"	"GCATGGGTGGTTCAGTGGTAGAATTCTCGCCTGCCACGCGGGAGGCCCGGGTTCGATTCCCGGCCCATGCA"	71	"tRNA-Gly-GCC-1"
"Homo_sapiens_tRNA-Gly-GCC-1-4"	"GCATGGGTGGTTCAGTGGTAGAATTCTCGCCTGCCACGCGGGAGGCCCGGGTTCGATTCCCGGCCCATGCA"	71	"tRNA-Gly-GCC-1"
"Homo_sapiens_tRNA-Gly-GCC-1-5"	"GCATGGGTGGTTCAGTGGTAGAATTCTCGCCTGCCACGCGGGAGGCCCGGGTTCGATTCCCGGCCCATGCA"	71	"tRNA-Gly-GCC-1"
"Homo_sapiens_tRNA-Gly-GCC-2-1"	"GCATTGGTGGTTCAGTGGTAGAATTCTCGCCTGCCACGCGGGAGGCCCGGGTTCGATTCCCGGCCAATGCA"	71	"tRNA-Gly-GCC-2"
"Homo_sapiens_tRNA-Gly-GCC-2-2"	"GCATTGGTGGTTCAGTGGTAGAATTCTCGCCTGCCACGCGGGAGGCCCGGGTTCGATTCCCGGCCAATGCA"	71	"tRNA-Gly-GCC-2"
"Homo_sapiens_tRNA-Gly-GCC-2-3"	"GCATTGGTGGTTCAGTGGTAGAATTCTCGCCTGCCACGCGGGAGGCCCGGGTTCGATTCCCGGCCAATGCA"	71	"tRNA-Gly-GCC-2"
"Homo_sapiens_tRNA-Gly-GCC-2-4"	"GCATTGGTGGTTCAGTGGTAGAATTCTCGCCTGCCACGCGGGAGGCCCGGGTTCGATTCCCGGCCAATGCA"	71	"tRNA-Gly-GCC-2"
"Homo_sapiens_tRNA-Gly-GCC-2-5"	"GCATTGGTGGTTCAGTGGTAGAATTCTCGCCTGCCACGCGGGAGGCCCGGGTTCGATTCCCGGCCAATGCA"	71	"tRNA-Gly-GCC-2"
"Homo_sapiens_tRNA-Gly-GCC-2-6"	"GCATTGGTGGTTCAGTGGTAGAATTCTCGCCTGCCACGCGGGAGGCCCGGGTTCGATTCCCGGCCAATGCA"	71	"tRNA-Gly-GCC-2"
"Homo_sapiens_tRNA-Gly-TCC-2-1"	"GCGTTGGTGGTATAGTGGTGAGCATAGCTGCCTTCCAAGCAGTTGACCCGGGTTCGATTCCCGGCCAACGCA"	72	"tRNA-Gly-TCC-2"
"Homo_sapiens_tRNA-Gly-TCC-2-2"	"GCGTTGGTGGTATAGTGGTGAGCATAGCTGCCTTCCAAGCAGTTGACCCGGGTTCGATTCCCGGCCAACGCA"	72	"tRNA-Gly-TCC-2"
"Homo_sapiens_tRNA-Gly-TCC-2-3"	"GCGTTGGTGGTATAGTGGTGAGCATAGCTGCCTTCCAAGCAGTTGACCCGGGTTCGATTCCCGGCCAACGCA"	72	"tRNA-Gly-TCC-2"
"Homo_sapiens_tRNA-Gly-TCC-2-4"	"GCGTTGGTGGTATAGTGGTGAGCATAGCTGCCTTCCAAGCAGTTGACCCGGGTTCGATTCCCGGCCAACGCA"	72	"tRNA-Gly-TCC-2"
"Homo_sapiens_tRNA-Gly-TCC-2-5"	"GCGTTGGTGGTATAGTGGTGAGCATAGCTGCCTTCCAAGCAGTTGACCCGGGTTCGATTCCCGGCCAACGCA"	72	"tRNA-Gly-TCC-2"
"Homo_sapiens_tRNA-Gly-TCC-2-6"	"GCGTTGGTGGTATAGTGGTGAGCATAGCTGCCTTCCAAGCAGTTGACCCGGGTTCGATTCCCGGCCAACGCA"	72	"tRNA-Gly-TCC-2"
"Homo_sapiens_tRNA-His-GTG-1-1"	"GCCGTGATCGTATAGTGGTTAGTACTCTGCGTTGTGGCCGCAGCAACCTCGGTTCGAATCCGAGTCACGGCA"	72	"tRNA-His-GTG-1"
"Homo_sapiens_tRNA-His-GTG-1-2"	"GCCGTGATCGTATAGTGGTTAGTACTCTGCGTTGTGGCCGCAGCAACCTCGGTTCGAATCCGAGTCACGGCA"	72	"tRNA-His-GTG-1"
"Homo_sapiens_tRNA-His-GTG-1-3"	"GCCGTGATCGTATAGTGGTTAGTACTCTGCGTTGTGGCCGCAGCAACCTCGGTTCGAATCCGAGTCACGGCA"	72	"tRNA-His-GTG-1"
"Homo_sapiens_tRNA-His-GTG-1-4"	"GCCGTGATCGTATAGTGGTTAGTACTCTGCGTTGTGGCCGCAGCAACCTCGGTTCGAATCCGAGTCACGGCA"	72	"tRNA-His-GTG-1"
"Homo_sapiens_tRNA-His-GTG-1-5"	"GCCGTGATCGTATAGTGGTTAGTACTCTGCGTTGTGGCCGCAGCAACCTCGGTTCGAATCCGAGTCACGGCA"	72	"tRNA-His-GTG-1"
"Homo_sapiens_tRNA-His-GTG-1-6"	"GCCGTGATCGTATAGTGGTTAGTACTCTGCGTTGTGGCCGCAGCAACCTCGGTTCGAATCCGAGTCACGGCA"	72	"tRNA-His-GTG-1"
"Homo_sapiens_tRNA-His-GTG-1-7"	"GCCGTGATCGTATAGTGGTTAGTACTCTGCGTTGTGGCCGCAGCAACCTCGGTTCGAATCCGAGTCACGGCA"	72	"tRNA-His-GTG-1"
"Homo_sapiens_tRNA-His-GTG-1-8"	"GCCGTGATCGTATAGTGGTTAGTACTCTGCGTTGTGGCCGCAGCAACCTCGGTTCGAATCCGAGTCACGGCA"	72	"tRNA-His-GTG-1"
"Homo_sapiens_tRNA-His-GTG-1-9"	"GCCGTGATCGTATAGTGGTTAGTACTCTGCGTTGTGGCCGCAGCAACCTCGGTTCGAATCCGAGTCACGGCA"	72	"tRNA-His-GTG-1"
"Homo_sapiens_tRNA-Ile-AAT-5-1"	"GGCCGGTTAGCTCAGTTGGTTAGAGCGTGGTGCTAATAACGCCAAGGTCGCGGGTTCGATCCCCGTACGGGCCA"	74	"tRNA-Ile-AAT-5"
"Homo_sapiens_tRNA-Ile-AAT-5-2"	"GGCCGGTTAGCTCAGTTGGTTAGAGCGTGGTGCTAATAACGCCAAGGTCGCGGGTTCGATCCCCGTACGGGCCA"	74	"tRNA-Ile-AAT-5"
"Homo_sapiens_tRNA-Ile-AAT-5-3"	"GGCCGGTTAGCTCAGTTGGTTAGAGCGTGGTGCTAATAACGCCAAGGTCGCGGGTTCGATCCCCGTACGGGCCA"	74	"tRNA-Ile-AAT-5"
"Homo_sapiens_tRNA-Ile-AAT-5-4"	"GGCCGGTTAGCTCAGTTGGTTAGAGCGTGGTGCTAATAACGCCAAGGTCGCGGGTTCGATCCCCGTACGGGCCA"	74	"tRNA-Ile-AAT-5"
"Homo_sapiens_tRNA-Ile-AAT-5-5"	"GGCCGGTTAGCTCAGTTGGTTAGAGCGTGGTGCTAATAACGCCAAGGTCGCGGGTTCGATCCCCGTACGGGCCA"	74	"tRNA-Ile-AAT-5"
"Homo_sapiens_tRNA-Ile-AAT-7-1"	"GGCCGGTTAGCTCAGTTGGTCAGAGCGTGGTGCTAATAACGCCAAGGTCGCGGGTTCGATCCCCGTACGGGCCA"	74	"tRNA-Ile-AAT-7"
"Homo_sapiens_tRNA-Ile-AAT-7-2"	"GGCCGGTTAGCTCAGTTGGTCAGAGCGTGGTGCTAATAACGCCAAGGTCGCGGGTTCGATCCCCGTACGGGCCA"	74	"tRNA-Ile-AAT-7"
"Homo_sapiens_tRNA-Ile-GAT-1-1"	"GGCCGGTTAGCTCAGTTGGTAAGAGCGTGGTGCTGATAACACCAAGGTCGCGGGCTCGACTCCCGCACCGGCCA"	74	"tRNA-Ile-GAT-1"
"Homo_sapiens_tRNA-Ile-GAT-1-2"	"GGCCGGTTAGCTCAGTTGGTAAGAGCGTGGTGCTGATAACACCAAGGTCGCGGGCTCGACTCCCGCACCGGCCA"	74	"tRNA-Ile-GAT-1"
"Homo_sapiens_tRNA-Ile-GAT-1-3"	"GGCCGGTTAGCTCAGTTGGTAAGAGCGTGGTGCTGATAACACCAAGGTCGCGGGCTCGACTCCCGCACCGGCCA"	74	"tRNA-Ile-GAT-1"
"Homo_sapiens_tRNA-Leu-AAG-1-1"	"GGTAGCGTGGCCGAGCGGTCTAAGGCGCTGGATTAAGGCTCCAGTCTCTTCGGAGGCGTGGGTTCGAATCCCACCGCTGCCA"	82	"tRNA-Leu-AAG-1"
"Homo_sapiens_tRNA-Leu-AAG-1-2"	"GGTAGCGTGGCCGAGCGGTCTAAGGCGCTGGATTAAGGCTCCAGTCTCTTCGGAGGCGTGGGTTCGAATCCCACCGCTGCCA"	82	"tRNA-Leu-AAG-1"
"Homo_sapiens_tRNA-Leu-AAG-1-3"	"GGTAGCGTGGCCGAGCGGTCTAAGGCGCTGGATTAAGGCTCCAGTCTCTTCGGAGGCGTGGGTTCGAATCCCACCGCTGCCA"	82	"tRNA-Leu-AAG-1"
"Homo_sapiens_tRNA-Leu-AAG-2-1"	"GGTAGCGTGGCCGAGCGGTCTAAGGCGCTGGATTAAGGCTCCAGTCTCTTCGGGGGCGTGGGTTCGAATCCCACCGCTGCCA"	82	"tRNA-Leu-AAG-2"
"Homo_sapiens_tRNA-Leu-AAG-2-2"	"GGTAGCGTGGCCGAGCGGTCTAAGGCGCTGGATTAAGGCTCCAGTCTCTTCGGGGGCGTGGGTTCGAATCCCACCGCTGCCA"	82	"tRNA-Leu-AAG-2"
"Homo_sapiens_tRNA-Leu-AAG-2-3"	"GGTAGCGTGGCCGAGCGGTCTAAGGCGCTGGATTAAGGCTCCAGTCTCTTCGGGGGCGTGGGTTCGAATCCCACCGCTGCCA"	82	"tRNA-Leu-AAG-2"
"Homo_sapiens_tRNA-Leu-AAG-2-4"	"GGTAGCGTGGCCGAGCGGTCTAAGGCGCTGGATTAAGGCTCCAGTCTCTTCGGGGGCGTGGGTTCGAATCCCACCGCTGCCA"	82	"tRNA-Leu-AAG-2"
"Homo_sapiens_tRNA-Leu-CAG-1-1"	"GTCAGGATGGCCGAGCGGTCTAAGGCGCTGCGTTCAGGTCGCAGTCTCCCCTGGAGGCGTGGGTTCGAATCCCACTCCTGACA"	83	"tRNA-Leu-CAG-1"
"Homo_sapiens_tRNA-Leu-CAG-1-2"	"GTCAGGATGGCCGAGCGGTCTAAGGCGCTGCGTTCAGGTCGCAGTCTCCCCTGGAGGCGTGGGTTCGAATCCCACTCCTGACA"	83	"tRNA-Leu-CAG-1"
"Homo_sapiens_tRNA-Leu-CAG-1-3"	"GTCAGGATGGCCGAGCGGTCTAAGGCGCTGCGTTCAGGTCGCAGTCTCCCCTGGAGGCGTGGGTTCGAATCCCACTCCTGACA"	83	"tRNA-Leu-CAG-1"
"Homo_sapiens_tRNA-Leu-CAG-1-4"	"GTCAGGATGGCCGAGCGGTCTAAGGCGCTGCGTTCAGGTCGCAGTCTCCCCTGGAGGCGTGGGTTCGAATCCCACTCCTGACA"	83	"tRNA-Leu-CAG-1"
"Homo_sapiens_tRNA-Leu-CAG-1-5"	"GTCAGGATGGCCGAGCGGTCTAAGGCGCTGCGTTCAGGTCGCAGTCTCCCCTGGAGGCGTGGGTTCGAATCCCACTCCTGACA"	83	"tRNA-Leu-CAG-1"
"Homo_sapiens_tRNA-Leu-CAG-1-6"	"GTCAGGATGGCCGAGCGGTCTAAGGCGCTGCGTTCAGGTCGCAGTCTCCCCTGGAGGCGTGGGTTCGAATCCCACTCCTGACA"	83	"tRNA-Leu-CAG-1"
"Homo_sapiens_tRNA-Leu-CAG-1-7"	"GTCAGGATGGCCGAGCGGTCTAAGGCGCTGCGTTCAGGTCGCAGTCTCCCCTGGAGGCGTGGGTTCGAATCCCACTCCTGACA"	83	"tRNA-Leu-CAG-1"
"Homo_sapiens_tRNA-Leu-CAG-2-1"	"GTCAGGATGGCCGAGCGGTCTAAGGCGCTGCGTTCAGGTCGCAGTCTCCCCTGGAGGCGTGGGTTCGAATCCCACTTCTGACA"	83	"tRNA-Leu-CAG-2"
"Homo_sapiens_tRNA-Leu-CAG-2-2"	"GTCAGGATGGCCGAGCGGTCTAAGGCGCTGCGTTCAGGTCGCAGTCTCCCCTGGAGGCGTGGGTTCGAATCCCACTTCTGACA"	83	"tRNA-Leu-CAG-2"
"Homo_sapiens_tRNA-Lys-CTT-1-1"	"GCCCGGCTAGCTCAGTCGGTAGAGCATGGGACTCTTAATCCCAGGGTCGTGGGTTCGAGCCCCACGTTGGGCG"	73	"tRNA-Lys-CTT-1"
"Homo_sapiens_tRNA-Lys-CTT-1-2"	"GCCCGGCTAGCTCAGTCGGTAGAGCATGGGACTCTTAATCCCAGGGTCGTGGGTTCGAGCCCCACGTTGGGCG"	73	"tRNA-Lys-CTT-1"
"Homo_sapiens_tRNA-Lys-CTT-2-1"	"GCCCGGCTAGCTCAGTCGGTAGAGCATGAGACTCTTAATCTCAGGGTCGTGGGTTCGAGCCCCACGTTGGGCG"	73	"tRNA-Lys-CTT-2"
"Homo_sapiens_tRNA-Lys-CTT-2-2"	"GCCCGGCTAGCTCAGTCGGTAGAGCATGAGACTCTTAATCTCAGGGTCGTGGGTTCGAGCCCCACGTTGGGCG"	73	"tRNA-Lys-CTT-2"
"Homo_sapiens_tRNA-Lys-CTT-2-3"	"GCCCGGCTAGCTCAGTCGGTAGAGCATGAGACTCTTAATCTCAGGGTCGTGGGTTCGAGCCCCACGTTGGGCG"	73	"tRNA-Lys-CTT-2"
"Homo_sapiens_tRNA-Lys-CTT-2-4"	"GCCCGGCTAGCTCAGTCGGTAGAGCATGAGACTCTTAATCTCAGGGTCGTGGGTTCGAGCCCCACGTTGGGCG"	73	"tRNA-Lys-CTT-2"
"Homo_sapiens_tRNA-Lys-CTT-2-5"	"GCCCGGCTAGCTCAGTCGGTAGAGCATGAGACTCTTAATCTCAGGGTCGTGGGTTCGAGCCCCACGTTGGGCG"	73	"tRNA-Lys-CTT-2"
"Homo_sapiens_tRNA-Lys-TTT-3-1"	"GCCCGGATAGCTCAGTCGGTAGAGCATCAGACTTTTAATCTGAGGGTCCAGGGTTCAAGTCCCTGTTCGGGCG"	73	"tRNA-Lys-TTT-3"
"Homo_sapiens_tRNA-Lys-TTT-3-2"	"GCCCGGATAGCTCAGTCGGTAGAGCATCAGACTTTTAATCTGAGGGTCCAGGGTTCAAGTCCCTGTTCGGGCG"	73	"tRNA-Lys-TTT-3"
"Homo_sapiens_tRNA-Lys-TTT-3-3"	"GCCCGGATAGCTCAGTCGGTAGAGCATCAGACTTTTAATCTGAGGGTCCAGGGTTCAAGTCCCTGTTCGGGCG"	73	"tRNA-Lys-TTT-3"
"Homo_sapiens_tRNA-Lys-TTT-3-4"	"GCCCGGATAGCTCAGTCGGTAGAGCATCAGACTTTTAATCTGAGGGTCCAGGGTTCAAGTCCCTGTTCGGGCG"	73	"tRNA-Lys-TTT-3"
"Homo_sapiens_tRNA-Lys-TTT-3-5"	"GCCCGGATAGCTCAGTCGGTAGAGCATCAGACTTTTAATCTGAGGGTCCAGGGTTCAAGTCCCTGTTCGGGCG"	73	"tRNA-Lys-TTT-3"
"Homo_sapiens_tRNA-Met-CAT-3-1"	"GCCTCCTTAGCGCAGTAGGCAGCGCGTCAGTCTCATAATCTGAAGGTCCTGAGTTCGAACCTCAGAGGGGGCA"	73	"tRNA-Met-CAT-3"
"Homo_sapiens_tRNA-Met-CAT-3-2"	"GCCTCCTTAGCGCAGTAGGCAGCGCGTCAGTCTCATAATCTGAAGGTCCTGAGTTCGAACCTCAGAGGGGGCA"	73	"tRNA-Met-CAT-3"
"Homo_sapiens_tRNA-Met-CAT-4-1"	"GCCCTCTTAGCGCAGCGGGCAGCGCGTCAGTCTCATAATCTGAAGGTCCTGAGTTCGAGCCTCAGAGAGGGCA"	73	"tRNA-Met-CAT-4"
"Homo_sapiens_tRNA-Met-CAT-4-2"	"GCCCTCTTAGCGCAGCGGGCAGCGCGTCAGTCTCATAATCTGAAGGTCCTGAGTTCGAGCCTCAGAGAGGGCA"	73	"tRNA-Met-CAT-4"
"Homo_sapiens_tRNA-Met-CAT-4-3"	"GCCCTCTTAGCGCAGCGGGCAGCGCGTCAGTCTCATAATCTGAAGGTCCTGAGTTCGAGCCTCAGAGAGGGCA"	73	"tRNA-Met-CAT-4"
"Homo_sapiens_tRNA-Met-CAT-5-1"	"GCCCTCTTAGCGCAGCTGGCAGCGCGTCAGTCTCATAATCTGAAGGTCCTGAGTTCAAGCCTCAGAGAGGGCA"	73	"tRNA-Met-CAT-5"
"Homo_sapiens_tRNA-Met-CAT-5-2"	"GCCCTCTTAGCGCAGCTGGCAGCGCGTCAGTCTCATAATCTGAAGGTCCTGAGTTCAAGCCTCAGAGAGGGCA"	73	"tRNA-Met-CAT-5"
"Homo_sapiens_tRNA-Phe-GAA-1-1"	"GCCGAAATAGCTCAGTTGGGAGAGCGTTAGACTGAAGATCTAAAGGTCCCTGGTTCGATCCCGGGTTTCGGCA"	73	"tRNA-Phe-GAA-1"
"Homo_sapiens_tRNA-Phe-GAA-1-2"	"GCCGAAATAGCTCAGTTGGGAGAGCGTTAGACTGAAGATCTAAAGGTCCCTGGTTCGATCCCGGGTTTCGGCA"	73	"tRNA-Phe-GAA-1"
"Homo_sapiens_tRNA-Phe-GAA-1-3"	"GCCGAAATAGCTCAGTTGGGAGAGCGTTAGACTGAAGATCTAAAGGTCCCTGGTTCGATCCCGGGTTTCGGCA"	73	"tRNA-Phe-GAA-1"
"Homo_sapiens_tRNA-Phe-GAA-1-4"	"GCCGAAATAGCTCAGTTGGGAGAGCGTTAGACTGAAGATCTAAAGGTCCCTGGTTCGATCCCGGGTTTCGGCA"	73	"tRNA-Phe-GAA-1"
"Homo_sapiens_tRNA-Phe-GAA-1-5"	"GCCGAAATAGCTCAGTTGGGAGAGCGTTAGACTGAAGATCTAAAGGTCCCTGGTTCGATCCCGGGTTTCGGCA"	73	"tRNA-Phe-GAA-1"
"Homo_sapiens_tRNA-Phe-GAA-1-6"	"GCCGAAATAGCTCAGTTGGGAGAGCGTTAGACTGAAGATCTAAAGGTCCCTGGTTCGATCCCGGGTTTCGGCA"	73	"tRNA-Phe-GAA-1"
"Homo_sapiens_tRNA-Pro-AGG-2-1"	"GGCTCGTTGGTCTAGGGGTATGATTCTCGCTTAGGGTGCGAGAGGTCCCGGGTTCAAATCCCGGACGAGCCC"	72	"tRNA-Pro-AGG-2"
"Homo_sapiens_tRNA-Pro-AGG-2-2"	"GGCTCGTTGGTCTAGGGGTATGATTCTCGCTTAGGGTGCGAGAGGTCCCGGGTTCAAATCCCGGACGAGCCC"	72	"tRNA-Pro-AGG-2"
"Homo_sapiens_tRNA-Pro-AGG-2-3"	"GGCTCGTTGGTCTAGGGGTATGATTCTCGCTTAGGGTGCGAGAGGTCCCGGGTTCAAATCCCGGACGAGCCC"	72	"tRNA-Pro-AGG-2"
"Homo_sapiens_tRNA-Pro-AGG-2-4"	"GGCTCGTTGGTCTAGGGGTATGATTCTCGCTTAGGGTGCGAGAGGTCCCGGGTTCAAATCCCGGACGAGCCC"	72	"tRNA-Pro-AGG-2"
"Homo_sapiens_tRNA-Pro-AGG-2-5"	"GGCTCGTTGGTCTAGGGGTATGATTCTCGCTTAGGGTGCGAGAGGTCCCGGGTTCAAATCCCGGACGAGCCC"	72	"tRNA-Pro-AGG-2"
"Homo_sapiens_tRNA-Pro-AGG-2-6"	"GGCTCGTTGGTCTAGGGGTATGATTCTCGCTTAGGGTGCGAGAGGTCCCGGGTTCAAATCCCGGACGAGCCC"	72	"tRNA-Pro-AGG-2"
"Homo_sapiens_tRNA-Pro-AGG-2-7"	"GGCTCGTTGGTCTAGGGGTATGATTCTCGCTTAGGGTGCGAGAGGTCCCGGGTTCAAATCCCGGACGAGCCC"	72	"tRNA-Pro-AGG-2"
"Homo_sapiens_tRNA-Pro-AGG-2-8"	"GGCTCGTTGGTCTAGGGGTATGATTCTCGCTTAGGGTGCGAGAGGTCCCGGGTTCAAATCCCGGACGAGCCC"	72	"tRNA-Pro-AGG-2"
"Homo_sapiens_tRNA-Pro-CGG-1-1"	"GGCTCGTTGGTCTAGGGGTATGATTCTCGCTTCGGGTGCGAGAGGTCCCGGGTTCAAATCCCGGACGAGCCC"	72	"tRNA-Pro-CGG-1"
"Homo_sapiens_tRNA-Pro-CGG-1-2"	"GGCTCGTTGGTCTAGGGGTATGATTCTCGCTTCGGGTGCGAGAGGTCCCGGGTTCAAATCCCGGACGAGCCC"	72	"tRNA-Pro-CGG-1"
"Homo_sapiens_tRNA-Pro-CGG-1-3"	"GGCTCGTTGGTCTAGGGGTATGATTCTCGCTTCGGGTGCGAGAGGTCCCGGGTTCAAATCCCGGACGAGCCC"	72	"tRNA-Pro-CGG-1"
"Homo_sapiens_tRNA-Pro-TGG-3-1"	"GGCTCGTTGGTCTAGGGGTATGATTCTCGCTTTGGGTGCGAGAGGTCCCGGGTTCAAATCCCGGACGAGCCC"	72	"tRNA-Pro-TGG-3"
"Homo_sapiens_tRNA-Pro-TGG-3-2"	"GGCTCGTTGGTCTAGGGGTATGATTCTCGCTTTGGGTGCGAGAGGTCCCGGGTTCAAATCCCGGACGAGCCC"	72	"tRNA-Pro-TGG-3"
"Homo_sapiens_tRNA-Pro-TGG-3-3"	"GGCTCGTTGGTCTAGGGGTATGATTCTCGCTTTGGGTGCGAGAGGTCCCGGGTTCAAATCCCGGACGAGCCC"	72	"tRNA-Pro-TGG-3"
"Homo_sapiens_tRNA-Pro-TGG-3-4"	"GGCTCGTTGGTCTAGGGGTATGATTCTCGCTTTGGGTGCGAGAGGTCCCGGGTTCAAATCCCGGACGAGCCC"	72	"tRNA-Pro-TGG-3"
"Homo_sapiens_tRNA-Pro-TGG-3-5"	"GGCTCGTTGGTCTAGGGGTATGATTCTCGCTTTGGGTGCGAGAGGTCCCGGGTTCAAATCCCGGACGAGCCC"	72	"tRNA-Pro-TGG-3"
"Homo_sapiens_tRNA-Ser-AGA-2-1"	"GTAGTCGTGGCCGAGTGGTTAAGGCGATGGACTAGAAATCCATTGGGGTCTCCCCGCGCAGGTTCGAATCCTGCCGACTACG"	82	"tRNA-Ser-AGA-2"
"Homo_sapiens_tRNA-Ser-AGA-2-2"	"GTAGTCGTGGCCGAGTGGTTAAGGCGATGGACTAGAAATCCATTGGGGTCTCCCCGCGCAGGTTCGAATCCTGCCGACTACG"	82	"tRNA-Ser-AGA-2"
"Homo_sapiens_tRNA-Ser-AGA-2-3"	"GTAGTCGTGGCCGAGTGGTTAAGGCGATGGACTAGAAATCCATTGGGGTCTCCCCGCGCAGGTTCGAATCCTGCCGACTACG"	82	"tRNA-Ser-AGA-2"
"Homo_sapiens_tRNA-Ser-AGA-2-4"	"GTAGTCGTGGCCGAGTGGTTAAGGCGATGGACTAGAAATCCATTGGGGTCTCCCCGCGCAGGTTCGAATCCTGCCGACTACG"	82	"tRNA-Ser-AGA-2"
"Homo_sapiens_tRNA-Ser-AGA-2-5"	"GTAGTCGTGGCCGAGTGGTTAAGGCGATGGACTAGAAATCCATTGGGGTCTCCCCGCGCAGGTTCGAATCCTGCCGACTACG"	82	"tRNA-Ser-AGA-2"
"Homo_sapiens_tRNA-Ser-AGA-2-6"	"GTAGTCGTGGCCGAGTGGTTAAGGCGATGGACTAGAAATCCATTGGGGTCTCCCCGCGCAGGTTCGAATCCTGCCGACTACG"	82	"tRNA-Ser-AGA-2"
"Homo_sapiens_tRNA-Ser-GCT-4-1"	"GACGAGGTGGCCGAGTGGTTAAGGCGATGGACTGCTAATCCATTGTGCTCTGCACGCGTGGGTTCGAATCCCATCCTCGTCG"	82	"tRNA-Ser-GCT-4"
"Homo_sapiens_tRNA-Ser-GCT-4-2"	"GACGAGGTGGCCGAGTGGTTAAGGCGATGGACTGCTAATCCATTGTGCTCTGCACGCGTGGGTTCGAATCCCATCCTCGTCG"	82	"tRNA-Ser-GCT-4"
"Homo_sapiens_tRNA-Ser-GCT-4-3"	"GACGAGGTGGCCGAGTGGTTAAGGCGATGGACTGCTAATCCATTGTGCTCTGCACGCGTGGGTTCGAATCCCATCCTCGTCG"	82	"tRNA-Ser-GCT-4"
"Homo_sapiens_tRNA-Thr-AGT-1-1"	"GGCGCCGTGGCTTAGTTGGTTAAAGCGCCTGTCTAGTAAACAGGAGATCCTGGGTTCGAATCCCAGCGGTGCCT"	74	"tRNA-Thr-AGT-1"
"Homo_sapiens_tRNA-Thr-AGT-1-2"	"GGCGCCGTGGCTTAGTTGGTTAAAGCGCCTGTCTAGTAAACAGGAGATCCTGGGTTCGAATCCCAGCGGTGCCT"	74	"tRNA-Thr-AGT-1"
"Homo_sapiens_tRNA-Thr-AGT-1-3"	"GGCGCCGTGGCTTAGTTGGTTAAAGCGCCTGTCTAGTAAACAGGAGATCCTGGGTTCGAATCCCAGCGGTGCCT"	74	"tRNA-Thr-AGT-1"
"Homo_sapiens_tRNA-Thr-AGT-2-1"	"GGCTCCGTGGCTTAGCTGGTTAAAGCGCCTGTCTAGTAAACAGGAGATCCTGGGTTCGAATCCCAGCGGGGCCT"	74	"tRNA-Thr-AGT-2"
"Homo_sapiens_tRNA-Thr-AGT-2-2"	"GGCTCCGTGGCTTAGCTGGTTAAAGCGCCTGTCTAGTAAACAGGAGATCCTGGGTTCGAATCCCAGCGGGGCCT"	74	"tRNA-Thr-AGT-2"
"Homo_sapiens_tRNA-Trp-CCA-3-1"	"GACCTCGTGGCGCAACGGTAGCGCGTCTGACTCCAGATCAGAAGGTTGCGTGTTCAAATCACGTCGGGGTCA"	72	"tRNA-Trp-CCA-3"
"Homo_sapiens_tRNA-Trp-CCA-3-2"	"GACCTCGTGGCGCAACGGTAGCGCGTCTGACTCCAGATCAGAAGGTTGCGTGTTCAAATCACGTCGGGGTCA"	72	"tRNA-Trp-CCA-3"
"Homo_sapiens_tRNA-Trp-CCA-3-3"	"GACCTCGTGGCGCAACGGTAGCGCGTCTGACTCCAGATCAGAAGGTTGCGTGTTCAAATCACGTCGGGGTCA"	72	"tRNA-Trp-CCA-3"
"Homo_sapiens_tRNA-Val-AAC-1-1"	"GTTTCCGTAGTGTAGTGGTTATCACGTTCGCCTAACACGCGAAAGGTCCCCGGTTCGAAACCGGGCGGAAACA"	73	"tRNA-Val-AAC-1"
"Homo_sapiens_tRNA-Val-AAC-1-2"	"GTTTCCGTAGTGTAGTGGTTATCACGTTCGCCTAACACGCGAAAGGTCCCCGGTTCGAAACCGGGCGGAAACA"	73	"tRNA-Val-AAC-1"
"Homo_sapiens_tRNA-Val-AAC-1-3"	"GTTTCCGTAGTGTAGTGGTTATCACGTTCGCCTAACACGCGAAAGGTCCCCGGTTCGAAACCGGGCGGAAACA"	73	"tRNA-Val-AAC-1"
"Homo_sapiens_tRNA-Val-AAC-1-4"	"GTTTCCGTAGTGTAGTGGTTATCACGTTCGCCTAACACGCGAAAGGTCCCCGGTTCGAAACCGGGCGGAAACA"	73	"tRNA-Val-AAC-1"
"Homo_sapiens_tRNA-Val-AAC-1-5"	"GTTTCCGTAGTGTAGTGGTTATCACGTTCGCCTAACACGCGAAAGGTCCCCGGTTCGAAACCGGGCGGAAACA"	73	"tRNA-Val-AAC-1"
"Homo_sapiens_tRNA-Val-CAC-1-1"	"GTTTCCGTAGTGTAGTGGTTATCACGTTCGCCTCACACGCGAAAGGTCCCCGGTTCGAAACCGGGCGGAAACA"	73	"tRNA-Val-CAC-1"
"Homo_sapiens_tRNA-Val-CAC-1-2"	"GTTTCCGTAGTGTAGTGGTTATCACGTTCGCCTCACACGCGAAAGGTCCCCGGTTCGAAACCGGGCGGAAACA"	73	"tRNA-Val-CAC-1"
"Homo_sapiens_tRNA-Val-CAC-1-3"	"GTTTCCGTAGTGTAGTGGTTATCACGTTCGCCTCACACGCGAAAGGTCCCCGGTTCGAAACCGGGCGGAAACA"	73	"tRNA-Val-CAC-1"
"Homo_sapiens_tRNA-Val-CAC-1-4"	"GTTTCCGTAGTGTAGTGGTTATCACGTTCGCCTCACACGCGAAAGGTCCCCGGTTCGAAACCGGGCGGAAACA"	73	"tRNA-Val-CAC-1"
"Homo_sapiens_tRNA-Val-CAC-1-5"	"GTTTCCGTAGTGTAGTGGTTATCACGTTCGCCTCACACGCGAAAGGTCCCCGGTTCGAAACCGGGCGGAAACA"	73	"tRNA-Val-CAC-1"
"Homo_sapiens_tRNA-Val-CAC-1-6"	"GTTTCCGTAGTGTAGTGGTTATCACGTTCGCCTCACACGCGAAAGGTCCCCGGTTCGAAACCGGGCGGAAACA"	73	"tRNA-Val-CAC-1"
"Homo_sapiens_tRNA-Val-CAC-1-7"	"GTTTCCGTAGTGTAGTGGTTATCACGTTCGCCTCACACGCGAAAGGTCCCCGGTTCGAAACCGGGCGGAAACA"	73	"tRNA-Val-CAC-1"
"Homo_sapiens_tRNA-Val-CAC-5-1"	"GTTTCCGTAGTGTAGTGGTTATCACGTTCGCCTCACACGCGAAAGGTCCCCGGTTCGAAACCGGGCGGAAACA"	73	"tRNA-Val-CAC-5"
"Homo_sapiens_tRNA-Val-TAC-1-1"	"GGTTCCATAGTGTAGTGGTTATCACGTCTGCTTTACACGCAGAAGGTCCTGGGTTCGAGCCCCAGTGGAACCA"	73	"tRNA-Val-TAC-1"
"Homo_sapiens_tRNA-Val-TAC-1-2"	"GGTTCCATAGTGTAGTGGTTATCACGTCTGCTTTACACGCAGAAGGTCCTGGGTTCGAGCCCCAGTGGAACCA"	73	"tRNA-Val-TAC-1"
"Homo_sapiens_tRNA-iMet-CAT-1-1"	"AGCAGAGTGGCGCAGCGGAAGCGTGCTGGGCCCATAACCCAGAGGTCGATGGATCGAAACCATCCTCTGCTA"	72	"tRNA-iMet-CAT-1"
"Homo_sapiens_tRNA-iMet-CAT-1-2"	"AGCAGAGTGGCGCAGCGGAAGCGTGCTGGGCCCATAACCCAGAGGTCGATGGATCGAAACCATCCTCTGCTA"	72	"tRNA-iMet-CAT-1"
"Homo_sapiens_tRNA-iMet-CAT-1-3"	"AGCAGAGTGGCGCAGCGGAAGCGTGCTGGGCCCATAACCCAGAGGTCGATGGATCGAAACCATCCTCTGCTA"	72	"tRNA-iMet-CAT-1"
"Homo_sapiens_tRNA-iMet-CAT-1-4"	"AGCAGAGTGGCGCAGCGGAAGCGTGCTGGGCCCATAACCCAGAGGTCGATGGATCGAAACCATCCTCTGCTA"	72	"tRNA-iMet-CAT-1"
"Homo_sapiens_tRNA-iMet-CAT-1-5"	"AGCAGAGTGGCGCAGCGGAAGCGTGCTGGGCCCATAACCCAGAGGTCGATGGATCGAAACCATCCTCTGCTA"	72	"tRNA-iMet-CAT-1"
"Homo_sapiens_tRNA-iMet-CAT-1-6"	"AGCAGAGTGGCGCAGCGGAAGCGTGCTGGGCCCATAACCCAGAGGTCGATGGATCGAAACCATCCTCTGCTA"	72	"tRNA-iMet-CAT-1"
"Homo_sapiens_tRNA-iMet-CAT-1-7"	"AGCAGAGTGGCGCAGCGGAAGCGTGCTGGGCCCATAACCCAGAGGTCGATGGATCGAAACCATCCTCTGCTA"	72	"tRNA-iMet-CAT-1"
"Homo_sapiens_tRNA-iMet-CAT-1-8"	"AGCAGAGTGGCGCAGCGGAAGCGTGCTGGGCCCATAACCCAGAGGTCGATGGATCGAAACCATCCTCTGCTA"	72	"tRNA-iMet-CAT-1"
